<tdmsfile>
<tdmsfile>
Han1.hwp  2차 수정(박현이)
신한국당	신한국당/nq
비주류	비/xp+주류/ncn
의원	의원/ncn
4명이	4/nnc+명/nbu+이/jcs
2일	2/nno+일/nbu
추가로	추가/ncn+로/jca
탈당을	탈당/ncn+을/jco
선언한	선언/ncpa+하/xsv+ㄴ/etm
가운데	가운데/ncn
이회창	이회창/nq
총재는	총재/ncn+는/jxc
`디제이피(김대중	`/sl+디제이피/nq+(/sl+김대중/nq
김종필)	김종필/nq+)/sr
연합'의	연합/ncn+'/sr+의/jcm
내각제	내각/ncn+제/xsn
개헌론을	개헌/ncn+론/xsn+을/jco
정면	정면/ncn
비판하면서	비판/ncpa+하/xsv+면서/ecs
대선	대선/ncn
정국의	정국/ncn+의/jcm
쟁점	쟁점/ncn
변화를	변화/ncn+를/jco
시도하고	시도/ncpa+하/xsv+고/ecs
나섰다.	나서/pvg+었/ep+다/ef+./sf
이들은	이/npp+들/xsn+은/jxc
이미	이미/mag
탈당한	탈당/ncpa+하/xsv+ㄴ/etm
이만섭	이만섭/nq
전	전/mma
국회의장과	국회/ncn+의장/ncn+과/jct
함께	함께/mag
3일	3/nno+일/nbu
오전	오전/ncn
이인제	이인제/nq
전	전/mma
경기지사의	경기/nq+지사/ncn+의/jcm
국민신당(가칭)에	국민신당/nq+(/sl+가칭/ncn+)/sr+에/jca
입당하기로	입당/ncpa+하/xsv+기/etn+로/jca
했다.	하/px+었/ep+다/ef+./sf
임범	임범/nq
기자는	기자/ncn+는/jxc
그동안	그/mmd+동안/ncn
완만한	완만/ncps+하/xsm+ㄴ/etm
하강추세속에	하강/ncn+추세/ncn+속/ncn+에/jca
조정국면을	조정/ncn+국면/ncn+을/jco
보이던	보이/pvg+던/etm
경기가	경기/ncn+가/jcs
금융시장	금융/ncn+시장/ncn
불안지속	불안/ncn+지속/ncn
등으로	등/nbn+으로/jca
이달에는	이/mmd+달/ncn+에/jca+는/jxc
다시	다시/mag
급락할	급락/ncpa+하/xsv+ㄹ/etm
것으로	것/nbn+으로/jca
전망됐다.	전망/ncpa+되/xsv+었/ep+다/ef+./sf
전국경제인연합회는	전국경제인연합회/nq+는/jxc
최근	최근/ncn
업종별	업종/ncn+별/xsn
매출액	매출/ncn+액/xsn
순위	순위/ncn
600대	600/nno+대/xsn
기업을	기업/ncn+을/jco
대상으로	대상/ncn+으로/jca
조사한	조사/ncpa+하/xsv+ㄴ/etm
결과,	결과/ncn+,/sp
11월	11/nno+월/nbu
중	중/nbn
계절조정	계절/ncn+조정/ncn
종합기업경기실사지수	종합/ncn+기업/ncn+경기/ncn+실사/ncn+지수/ncn
(BSI)	(/sl+BSI/f+)/sr
전망치가	전망/ncn+치/xsn+가/jcs
76.5로	76.5/nnc+로/jca
한보사태가	한보/nq+사태/ncn+가/jcs
지속되던	지속/ncpa+되/xsv+던/etm
올해	올해/ncn
4월(74.4)	4/nno+월/nbu+(/sl+74.4/nnc+)/sr
이후	이후/ncn
최저치로	최저/ncn+치/xsn+로/jca
떨어졌다고	떨어지/pvg+었/ep+다/ef+고/jcr
2일	2/nno+일/nbu
밝혔다.	밝히/pvg+었/ep+다/ef+./sf
경기실사지수는	경기/ncn+실사/ncn+지수/ncn+는/jxc
100이	100/nnc+이/jcs
기준이며,	기준/ncn+이/jp+며/ecc+,/sp
이보다	이/npd+보다/jca
낮으면	낮/paa+으면/ecs
경기를	경기/ncn+를/jco
어둡게	어둡/paa+게/ecs
보는	보/pvg+는/etm
사람이	사람/ncn+이/jcs
많다는	많/paa+다/ef+는/etm
것을	것/nbn+을/jco
뜻한다.	뜻/ncpa+하/xsv+ㄴ다/ef+./sf
전경련은	전경련/nq+은/jxc
기업자금사정	기업/ncn+자금/ncn+사정/ncn
악화에	악화/ncn+에/jca
따른	따르/pvg+ㄴ/etm
경영불안	경영/ncn+불안/ncn
요인이	요인/ncn+이/jcs
기업의	기업/ncn+의/jcm
체감경기	체감/ncn+경기/ncn
침체를	침체/ncn+를/jco
주도하고	주도/ncpa+하/xsv+고/ecx
있는	있/px+는/etm
것으로	것/nbn+으로/jca
분석되며,	분석/ncpa+되/xsv+며/ecc+,/sp
이에	이/npd+에/jca
따라	따르/pvg+아/ecs
기업의	기업/ncn+의/jcm
투자심리도	투자/ncn+심리/ncn+도/jxc
상당히	상당/ncn+히/xsa
위축될	위축/ncpa+되/xsv+ㄹ/etm
것으로	것/nbn+으로/jca
내다봤다.	내다보/pvg+았/ep+다/ef+./sf
내수판매	내수/ncn+판매/ncn
전망지수는	전망/ncn+지수/ncn+는/jxc
소비심리	소비/ncn+심리/ncn
위축으로	위축/ncn+으로/jca
102에	102/nnc+에/jca
머물러,	머무르/pvg+어/ecs+,/sp
계절적	계절/ncn+적/xsn
성수기를	성수/ncn+기/xsn+를/jco
앞두고	앞/ncn+두/pvg+고/ecx
있음에도	있/px+음/etn+에/jca+도/jxc
내수판매가	내수/ncn+판매/ncn+가/jcs
늘지	늘/pvg+지/ecx
않을	않/px+을/etm
것으로	것/nbn+으로/jca
전망됐다.	전망/ncpa+되/xsv+었/ep+다/ef+./sf
기업의	기업/ncn+의/jcm
자금사정(전망치	자금/ncn+사정/ncn+(/sl+전망/ncn+치/xsn
83)은	83/nnc+)/sr+은/jxc
동남아,	동남아/nq+,/sp
일본	일본/nq
등의	등/nbn+의/jcm
동반주가폭락에	동반/ncn+주가/ncn+폭락/ncn+에/jca
따른	따르/pvg+ㄴ/etm
불안심리와	불안/ncn+심리/ncn+와/jct
함께	함께/mag
금융권의	금융/ncn+권/xsn+의/jcm
보수적인	보수/ncn+적/xsn+이/jp+ㄴ/etm
자금운영으로	자금/ncn+운영/ncn+으로/jca
어려움이	어려움/ncn+이/jcs
지속될	지속/ncpa+되/xsv+ㄹ/etm
것으로	것/nbn+으로/jca
예상됐다.	예상/ncpa+되/xsv+었/ep+다/ef+./sf
기업의	기업/ncn+의/jcm
투자집행	투자/ncn+집행/ncn
지수도	지수/ncn+도/jxc
경기전망	경기/ncn+전망/ncn
불투명,	불/xp+투명/ncn+,/sp
자금시장	자금/ncn+시장/ncn
악화를	악화/ncn+를/jco
반영해	반영/ncpa+하/xsv+어/ecs
77로	77/nnc+로/jca
나타나	나타나/pvg+아/ecs
부진이	부진/ncn+이/jcs
계속될	계속/ncpa+되/xsv+ㄹ/etm
것으로	것/nbn+으로/jca
예측됐다.	예측/ncpa+되/xsv+었/ep+다/ef+./sf
오는	오/pvg+는/etm
99년부터	99/nno+년/nbu+부터/jxc
서울의	서울/nq+의/jcm
각	각/mma
가정에서는	가정/ncn+에서/jca+는/jxc
지역별로	지역/ncn+별/xsn+로/jca
지정된	지정/ncpa+되/xsv+ㄴ/etm
날짜와	날짜/ncn+와/jcj
시간에	시간/ncn+에/jca
맞춰	맞추/pvg+어/ecs
쓰레기를	쓰레기/ncn+를/jco
배출해야	배출/ncpa+하/xsv+어야/ecs
하며	하/px+며/ecs
이를	이/npd+를/jco
어길	어기/pvg+ㄹ/etm
경우	경우/ncn
과태료가	과태/ncn+료/xsn+가/jcs
부과된다.	부과/ncpa+되/xsv+ㄴ다/ef+./sf
또	또/maj
파손되기	파손/ncpa+되/xsv+기/etn
쉬운	쉽/paa+ㄴ/etm
현재의	현재/ncn+의/jcm
종량제	종량/ncn+제/xsn
규격봉투	규격/ncn+봉투/ncn
대신	대신/ncn
재활용이	재/xp+활용/ncn+이/jcs
가능한	가능/ncps+하/xsm+ㄴ/etm
플라스틱통이	플라스틱/ncn+통/ncn+이/jcs
쓰레기	쓰레기/ncn
배출용기로	배출/ncn+용기/ncn+로/jca
보급되며	보급/ncpa+되/xsv+며/ecc
2000년부터는	2000/nno+년/nbu+부터/jxc+는/jxc
쓰레기	쓰레기/ncn
수거체계도	수거/ncn+체계/ncn+도/jxc
현재의	현재/ncn+의/jcm
종이,	종이/ncn+,/sp
플라스틱류,	플라스틱/ncn+류/xsn+,/sp
유리병류,	유리/ncn+병/ncn+류/xsn+,/sp
캔류,	캔/ncn+류/xsn+,/sp
고철류	고철/ncn+류/xsn
등	등/nbn
5종에서	5/nnc+종/nbu+에서/jca
종이류와	종이/ncn+류/xsn+와/jcj
기타류	기타/ncn+류/xsn
등	등/nbn
2종으로	2/nnc+종/nbu+으로/jca
전환된다.	전환/ncpa+되/xsv+ㄴ다/ef+./sf
서울시는	서울시/nq+는/jxc
이같은	이/npd+같/paa+은/etm
내용을	내용/ncn+을/jco
골자로	골자/ncn+로/jca
하는	하/pvg+는/etm
폐기물관리	폐기/ncn+물/xsn+관리/ncn
종합계획을	종합/ncn+계획/ncn+을/jco
마련,	마련/ncn+,/sp
단계적으로	단계/ncn+적/xsn+으로/jca
시행키로	시행/ncpa+키/etn+로/jca
했다고	하/px+었/ep+다/ef+고/jcr
2일	2/nno+일/nbu
밝혔다.	밝히/pvg+었/ep+다/ef+./sf
시는	시/ncn+는/jxc
이에	이/npd+에/jca
따라	따르/pvg+아/ecs
99년부터는	99/nno+년/nbu+부터/jxc+는/jxc
지역별로	지역/ncn+별/xsn+로/jca
쓰레기	쓰레기/ncn
수거일을	수거/ncn+일/xsn+을/jco
지정하고	지정/ncpa+하/xsv+고/ecs
각	각/mma
가정에서는	가정/ncn+에서/jca+는/jxc
수거일	수거/ncn+일/xsn
전날	전/mma+날/ncn
해가	해/ncn+가/jcs
진	지/pvg+ㄴ/etm
뒤에	뒤/ncn+에/jca
쓰레기를	쓰레기/ncn+를/jco
버리도록	버리/pvg+도록/ecs
하며	하/px+며/ecs
이를	이/npd+를/jco
어길	어기/pvg+ㄹ/etm
경우	경우/ncn
과태료를	과태/ncn+료/xsn+를/jco
부과할	부과/ncpa+하/xsv+ㄹ/etm
수	수/nbn
있도록	있/paa+도록/ecs
관련조례를	관련/ncn+조례/ncn+를/jco
개정키로	개정/ncpa+키/etn+로/jca
했다.	하/px+었/ep+다/ef+./sf
또	또/maj
종량제	종량/ncn+제/xsn
규격봉투의	규격/ncn+봉투/ncn+의/jcm
파손으로	파손/ncn+으로/jca
인한	인하/pvg+ㄴ/etm
오물	오물/ncn
방출을	방출/ncn+을/jco
막기	막/pvg+기/etn
위해	위하/pvg+어/ecs
견고하게	견고/ncps+하/xsm+게/ecs
제작된	제작/ncpa+되/xsv+ㄴ/etm
재활용	재/xp+활용/ncn
플라스틱통을	플라스틱/ncn+통/ncn+을/jco
쓰레기	쓰레기/ncn
배출용기로	배출/ncn+용기/ncn+로/jca
도입하고	도입/ncpa+하/xsv+고/ecc
시민	시민/ncn
편의를	편의/ncn+를/jco
위해	위하/pvg+어/ecs
현행	현행/ncn
5종의	5/nnc+종/nbu+의/jcm
쓰레기	쓰레기/ncn
수거체계를	수거/ncn+체계/ncn+를/jco
2종으로	2/nnc+종/nbu+으로/jca
단순화하기로	단순/ncn+화/xsn+하/xsv+기/etn+로/jca
했다.	하/px+었/ep+다/ef+./sf
이밖에	이/npd+밖에/jxc
재활용품	재/xp+활용/ncn+품/xsn
수거작업을	수거/ncn+작업/ncn+을/jco
활성화하기	활성/ncn+화/xsn+하/xsv+기/etn
위해	위하/pvg+어/ecs
민간	민간/ncn
재활용업체에	재/xp+활용/ncn+업체/ncn+에/jca
대한	대하/pvg+ㄴ/etm
지원을	지원/ncn+을/ncn
확대하고	확대/ncpa+하/xsv+고/ecc
1회용품	1/nnc+회/nbu+용품/ncn
사용에	사용/ncn+에/jca
대한	대하/pvg+ㄴ/etm
단속을	단속/ncn+을/jco
강화하는	강화/ncpa+하/xsv+는/etm
한편,	한편/ncn+,/sp
음식물쓰레기	음식/ncn+물/xsn+쓰레기/ncn
처리를	처리/ncn+를/jco
위한	위하/pvg+ㄴ/etm
각종	각종/ncn
처리시설에	처리/ncn+시설/ncn+에/jca
대한	대하/pvg+ㄴ/etm
투자를	투자/ncn+를/jco
확대할	확대/ncpa+하/xsv+ㄹ/etm
방침이다.	방침/ncn+이/jp+다/ef+./sf
신한국당의	신한국당/nq+의/jcm
박범진	박범진/nq
이용삼	이용삼/nq
김학원	김학원/nq
원유철	원유철/nq
의원이	의원/ncn+이/jcs
2일	2/nno+일/nbu
탈당했다.	탈당/ncpa+하/xsv+었/ep+다/ef+./sf
한편	한편/maj
박종선	박종선/nq
김충근	김충근/nq
위원장도	위원/ncn+장/xsn+도/jxc
이날	이/mmd+날/ncn
탈당했으나,	탈당/ncpa+하/xsv+었/ep+으나/ecs+,/sp
김	김/nq
위원장은	위원/ncn+장/xsn+은/jxc
개인	개인/ncn
일정때문에	일정/ncn+때문/nbn+에/jca
회견장에는	회견/ncn+장/xsn+에/jca+는/jxc
참석치	참석/ncpa+하/xsv+지/ecx
않았다.	않/px+았/ep+다/ef+./sf
외국	외국/ncn
유명	유명/ncn
자동차회사와	자동/ncn+차/ncn+회사/ncn+와/jct
독점계약을	독점/ncn+계약/ncn+을/jco
맺고	맺/pvg+고/ecs
고급승용차를	고급/ncn+승용/ncn+차/ncn+를/jco
국내에	국내/ncn+에/jca
들여와	들이/pvg+어/ecs+오/pvg+아/ecs
팔고	팔/pvg+고/ecx
있는	있/px+는/etm
한	한/nnc
판매업체	판매/ncn+업체/ncn
임원의	임원/ncn+의/jcm
고백이다.	고백/ncn+이/jp+다/ef+./sf
말이	말/ncn+이/jcs
제휴지	제휴/ncn+지/ecs
어지간한	어지간/ncps+하/xsm+ㄴ/etm
시집살이만도	시집/ncn+살이/xsn+만/jxc+도/jxc
못한	못하/paa+ㄴ/etm
경우가	경우/ncn+가/jcs
적지	적/paa+지/ecx
않다.	않/px+다/ef+./sf
그런데	그런데/maj
최근들어	최근/ncn+들/pvg+어/ecs
시집살이마저	시집/ncn+살이/xsn+마저/jxc
깨지는	깨지/pvg+는/etm
조짐을	조짐/ncn+을/jco
보이고	보이/pvg+고/ecx
있다.	있/px+다/ef+./sf
몇십년을	몇십/nnc+년/nbu+을/jco
이어온	잇/pvg+어/ecx+오/px+ㄴ/etm
관계를	관계/ncn+를/jco
어떻게	어떻/pad+게/ecs
하루아침에	하루/ncn+아침/ncn+에/jca
끊을	끊/pvg+을/etm
수	수/nbn
있냐는	있/paa+냐/ef+는/etm
하소연은	하소연/ncn+은/jxc
통하지	통하/pvg+지/ecx
않는다.	않/px+는다/ef+./sf
`정략결혼'을	`/sl+정략/ncn+결혼/ncn+'/sr+을/jco
유지할	유지/ncpa+하/xsv+ㄹ/etm
필요성이	필요/ncn+성/xsn+이/jcs
없어진	없/paa+어/ecx+지/px+ㄴ/etm
외국기업의	외국/ncn+기업/ncn+의/jcm
철저한	철저/ncps+하/xsm+ㄴ/etm
이윤추구	이윤/ncn+추구/ncn
논리	논리/ncn
앞에서	앞/ncn+에서/jca
더	더/mag
이상	이상/ncn
`신의	`/sl+신의/ncn
원칙'은	원칙/ncn+'/sr+은/jxc
설득력이	설득/ncn+력/xsn+이/jcs
없기	없/paa+기/etn
때문이다.	때문/nbn+이/jp+다/ef+./sf
결별을	결별/ncn+을/jco
예상하고	예상/ncpa+하/xsv+고/ecs
미리	미리/mag
준비를	준비/ncn+를/jco
해온	하/pvg+어/ecx+오/px+ㄴ/etm
기업과	기업/ncn+과/jcj
그렇지	그렇/pad+지/ecx
못한	못하/px+ㄴ/etm
기업은	기업/ncn+은/jxc
명암이	명암/ncn+이/jcs
갈릴	갈리/pvg+ㄹ/etm
수	수/nbn
밖에	밖에/jxc
없다.	없/paa+다/ef+./sf
외국업체와	외국/ncn+업체/ncn+와/jct
손을	손/ncn+을/jco
잡았던	잡/pvg+았/ep+던/etm
국내	국내/ncn
업체들은	업체/ncn+들/xsn+은/jxc
적지	적/pvg+지/ecx
않게	않/px+게/ecs
시장만	시장/ncn+만/jxc
키워주고	키우/pvg+어/ecx+주/px+고/ecs
`찬밥	`/sl+찬밥/ncn
신세'가	신세/ncn+'/sr+가/jcs
되고	되/pvg+고/ecx
마는	말/px+는/etm
신세가	신세/ncn+가/jcs
됐다	되/pvg+었/ep+다/ef
외국업체와	외국/ncn+업체/ncn+와/jct
헤어진	헤어지/pvg+ㄴ/etm
뒤	뒤/ncn
충격을	충격/ncn+을/jco
견디지	견디/pvg+지/ecx
못하고	못하/px+고/ecs
부도위기까지	부도/ncn+위기/ncn+까지/jxc
간	가/pvg+ㄴ/etm
기업도	기업/ncn+도/jxc
있다.	있/paa+다/ef+./sf
코카콜라의	코카콜라/nq+의/jcm
4개	4/nnc+개/nbu
병입회사	병입/ncn+회사/ncn
중	중/nbn
한	한/nnc
곳이었던	곳/ncn+이/jp+었/ep+던/etm
우성식품은	우성식품/nq+은/jxc
올해초	올해/ncn+초/ncn
코카콜라사가	코카콜라사/nq+가/jcs
공장과	공장/ncn+과/jcj
영업권을	영업/ncn+권/xsn+을/jco
인수해	인수/ncpa+하/xsv+어/ecs
간	가/pvg+ㄴ/etm
뒤	뒤/ncn
심한	심하/paa+ㄴ/etm
자금난으로	자금/ncn+난/xsn+으로/jca
결국	결국/mag
7개월여만에	7/nnc+개월/nbu+여/xsn+만/jxc+에/jca
법원에	법원/ncn+에/jca
화의신청을	화의/ncn+신청/ncn+을/jco
냈다.	내/pvg+었/ep+다/ef+./sf
80년대	80/nno+년대/nbu
말부터는	말/ncn+부터/jxc+는/jxc
스낵과자류를	스낵/ncn+과자/ncn+류/xsn+를/jco
내놓고	내/pvg+어/ecx+놓/px+고/ecs
종합식품회사로	종합/ncn+식품/ncn+회사/ncn+로/jca
변신을	변신/ncn+을/jco
시도하기도	시도/ncpa+하/xsv+기/etn+도/jxc
했다.	하/pvg+었/ep+다/ef+./sf
하지만	하지만/maj
90년대	90/nno+년대/nbu
들어	들/pvg+어/ecs
외식,	외식/ncn+,/sp
의약품,	의약/ncn+품/xsn+,/sp
건강보조식품사업	건강/ncn+보조/ncn+식품/ncn+사업/ncn
등	등/nbn
사업다각화	사업/ncn+다각/ncn+화/xsn
계획이	계획/ncn+이/jcs
잇달아	잇달/pvg+아/ecs
차질을	차질/ncn+을/jco
빚으면서	빚/pvg+으면서/ecs
코카콜라에	코카콜라/nq+에/jca
지나치게	지나치/paa+게/ecs
의존하고	의존/ncpa+하/xsv+고/ecx
있는	있/px+는/etm
매출구조를	매출/ncn+구조/ncn+를/jco
개선하는	개선/ncpa+하/xsv+는/etm
데	데/nbn
실패했다.	실패/ncpa+하/xsv+었/ep+다/ef+./sf
아무런	아무렇/pad+ㄴ/etm
준비없이	준비/ncn+없/paa+이/xsa
강요당한	강요/ncn+당하/pvg+ㄴ/etm
꼴이	꼴/ncn+이/jcs
된	되/pvg+ㄴ/etm
코카콜라와의	코카콜라/nq+와/jct+의/jcm
결별은	결별/ncn+은/jxc
결국	결국/mag
우성식품에	우성식품/nq+에/jca
치명타가	치명타/ncn+가/jcs
되고	되/pvg+고/ecx
말았다.	말/px+았/ep+다/ef+./sf
반면	반면/maj
지난	지나/pvg+ㄴ/etm
95년	95/nno+년/nbu
스위스	스위스/nq
제약회사	제약/ncn+회사/ncn
`호프만	`/sl+nq[호프만/nq
라로슈'사와	라로슈/nq]nq+'/sr+사/xsn+와/jct
10년동안의	10/nnc+년/nbu+동안/ncn+의/jcm
합작관계를	합작/ncn+관계/ncn+를/jco
청산한	청산/ncpa+하/xsv+ㄴ/etm
종근당은	종근당/nq+은/jxc
결별을	결별/ncn+을/jco
오히려	오히려/mag
전기로	전기/ncn+로/jca
삼았다.	삼/pvg+았/ep+다/ef+./sf
종근당은	종근당/nq+은/jxc
83년	83/nno+년/nbu
로슈사와	로슈사/nq+와/jct
50대	50/nnc+대/nbn
50	50/nnc
합작투자로	합작/ncn+투자/ncn+로/jca
`한국로슈'를	`한국로슈'/nq+를/jco
세운	세우/pvg+ㄴ/etm
뒤	뒤/ncn
국내	국내/ncn
해열진통제	해열/ncn+진통/ncn+제/xsn
시장에서	시장/ncn+에서/jca
`사리돈'	`/sl+사리돈/nq+'/sr
선풍을	선풍/ncn+을/jco
일으켰다.	일으키/pvg+었/ep+다/ef+./sf
종근당의	종근당/nq+의/jcm
영업력과	영업/ncn+력/xsn+과/jcj
판매망을	판매/ncn+망/ncn+을/jco
이용해	이용/ncpa+하/xsv+어/ecs
시장개척에	시장/ncn+개척/ncn+에/jca
성공한	성공/ncpa+하/xsv+ㄴ/etm
로슈사는	로슈사/nq+는/jxc
95년	95/nno+년/nbu
종근당의	종근당/nq+의/jcm
지분을	지분/ncn+을/jco
인수해	인수/ncpa+하/xsv+어/ecs
직판체제를	직판/ncn+체제/ncn+를/jco
구축했다.	구축/ncpa+하/xsv+었/ep+다/ef+./sf
하지만	하지만/maj
종근당은	종근당/nq+은/jxc
다국적기업들이	다국/ncn+적/xsn+기업/ncn+들/xsn+이/jcs
시장점유율을	시장/ncn+점유/ncn+율/xsn+을/jco
확보한	확보/ncpa+하/xsv+ㄴ/etm
뒤	뒤/ncn
독립해	독립/ncpa+하/xsv+어/ecx
나가는	나가/px+는/etm
관행에	관행/ncn+에/jca
대비해	대비/ncpa+하/xsv+어/ecs
로슈사와	로슈사/nq+와/jct
기술제휴를	기술/ncn+제휴/ncn+를/jco
맺고	맺/pvg+고/ecx
있을	있/px+을/etm
당시	당시/ncn
순수	순수/ncn
국산제품인	국산/ncn+제품/ncn+이/jp+ㄴ/etm
`펜잘'을	`/sl+펜잘/nq+'/sr+을/jco
만들어	만들/pvg+어/ecx
놓고	놓/px+고/ecx
있었다.	있/px+었/ep+다/ef+./sf
`펜잘'은	`/sl+펜잘/nq+'/sr+은/jxc
시장에	시장/ncn+에/jca
내놓자마자	내/pvg+어/ecs+놓/pvg+자마자/ecs
곧바로	곧바로/mag
인정을	인정/ncn+을/jco
받았고	받/pvg+았/ep+고/ecs
지난해	지나/pvg+ㄴ/etm+해/ncn
60억원의	60억/nnc+원/nbu+의/jcm
매출을	매출/ncn+을/jco
올려	올리/pvg+어/ecs
70억원	70억/nnc+원/nbu
어치를	어치/xsn+를/jco
판	팔/pvg+ㄴ/etm
삼진제약의	삼진제약/nq+의/jcm
`게보린'에	`/sl+게보린/nq+'/sr+에/jca
이어	잇/pvg+어/ecs
부동의	부동/ncn+의/jcm
2위자리를	2/nno+위/nbu+자리/ncn+를/jco
지키고	지키/pvg+고/ecx
있다.	있/px+다/ef+./sf
반면	반면/maj
한때	한때/ncn
국내	국내/ncn
시장을	시장/ncn+을/jco
석권했던	석권/ncpa+하/xsv+었/ep+던/etm
`사리돈'은	`/sl+사리돈/nq+'/sr+은/jxc
지난해	지나/pvg+ㄴ/etm+해/ncn
매출이	매출/ncn+이/jcs
20억원에	20억/nnc+원/nbu+에/jca
그치는	그치/pvg+는/etm
등	등/nbn
직판을	직판/ncn+을/jco
시작한	시작/ncpa+하/xsv+ㄴ/etm
이후	이후/ncn
고전을	고전/ncn+을/jco
거듭하고	거듭/mag+하/xsv+고/ecx
있다.	있/px+다/ef+./sf
매출이	매출/ncn+이/jcs
급격히	급격/ncn+히/xsa
떨어지는	떨어지/pvg+는/etm
것에	것/nbn+에/jca
당황한	당황/ncpa+하/xsv+ㄴ/etm
로슈사는	로슈사/nq+는/jxc
직판을	직판/ncn+을/jco
포기하고	포기/ncpa+하/xsv+고/ecc
올해	올해/ncn
초	초/ncn
다시	다시/mag
국내업체인	국내/ncn+업체/ncn+이/jp+ㄴ/etm
광동제약과	광동제약/nq+과/jct
판매대행	판매/ncn+대행/ncn
계약을	계약/ncn+을/jco
맺었다.	맺/pvg+었/ep+다/ef+./sf
`아침에	`/sl+아침/ncn+에/jca
일어나면	일어나/pvg+면/ecs
누스킨	누스킨/nq
비누로	비누/ncn+로/jca
세수를	세수/ncn+를/jco
하고	하/pvg+고/ecc
암웨이	암웨이/nq
삼푸로	삼푸/ncn+로/jca
머리를	머리/ncn+를/jco
감은	감/pvg+은/etm
뒤	뒤/ncn
촉촉한	촉촉/ncps+하/xsm+ㄴ/etm
머리를	머리/ncn+를/jco
내쇼날	내쇼날/nq
헤어드라이어로	헤어드라이어/ncn+로/jca
말린다.	말리/pvg+ㄴ다/ef+./sf
켈로그	nq[켈로그/nq
콘프레이크에	콘프레이크/ncn]nq+에/jca
우유를	우유/ncn+를/jco
섞어	섞/pvg+어/ecs
아침을	아침/ncn+을/jco
떼우고,	떼우/pvg+고/ecc+,/sp
크리니크	크리니크/nq
스킨,	스킨/ncn+,/sp
에스티	nq[에스티/nq
로더	로더/nq]nq
로션으로	로션/ncn+으로/jca
피부를	피부/ncn+를/jco
정돈하고	정돈/ncpa+하/xsv+고/ecc
샤넬	샤넬/nq
화운데이션과	화운데이션/ncn+과/jcj
립스틱을	립스틱/ncn+을/jco
바른다.	바르/pvg+ㄴ다/ef+./sf
일본에	일본/nq+에/jca
주문해서	주문/ncpa+하/xsv+어서/ecs
맞춘	맞추/pvg+ㄴ/etm
속옷	속옷/ncn
위에	위/ncn+에/jca
프라다의	프라다/nq+의/jcm
투피스를	투피스/ncn+를/jco
꺼내입은	꺼내/pvg+어/ecs+입/pvg+은/etm
뒤	뒤/ncn
역시	역시/mag
샤넬	샤넬/nq
향수로	향수/ncn+로/jca
마무리를	마무리/ncn+를/jco
한다.	하/pvg+ㄴ다/ef+./sf
까르띠에	까르띠에/nq
시계가	시계/ncn+가/jcs
8시를	8/nno+시/nbu+를/jco
가리키는	가리키/pvg+는/etm
것을	것/nbn+을/jco
보고	보/pvg+고/ecs
루이비똥	루이비똥/nq
핸드백을	핸드백/ncn+을/jco
든	들/pvg+ㄴ/etm
다음	다음/ncn
구찌	구찌/nq
구두를	구두/ncn+를/jco
신고	신/pvg+고/ecs
제너널모터스의	제너널모터스/nq+의/jcm
최신형	최신/ncn+형/xsn
모델에	모델/ncn+에/jca
오른다.	오르/pvg+ㄴ다/ef+./sf
피자헛에서	피자헛/nq+에서/jca
코카콜라를	코카콜라/ncn+를/jco
곁들여	곁들이/pvg+어/ecs
가볍게	가볍/paa+게/ecs
점심	점심/ncn
식사를	식사/ncn+를/jco
하고,	하/pvg+고/ecc+,/sp
오후엔	오후/ncn+에/jca+ㄴ/jxc
리바이스	리바이스/nq
매장에	매장/ncn+에/jca
들러	들르/pvg+어/ecs
청바지를	청바지/ncn+를/jco
산다.	사/pvg+ㄴ다/ef+./sf
외국산	외국/ncn+산/xsn
소비재에	소비/ncn+재/xsn+에/jca
묻혀	묻히/pvg+어/ecs
사는	살/pvg+는/etm
우리의	우리/npp+의/jcm
일상을	일상/ncn+을/jco
가상으로	가상/ncn+으로/jca
꾸며본	꾸미/pvg+어/ecx+보/px+ㄴ/etm
것에	것/nbn+에/jca
불과하지만	불과/ncps+하/xsm+지만/ecs
요즘	요즘/mag
국내	국내/ncn
시장의	시장/ncn+의/jcm
형편을	형편/ncn+을/jco
살펴보면	살피/pvg+어/ecs+보/pvg+면/ecs
얼토당토한	얼토당토하/paa+ㄴ/etm
얘기만은	얘기/ncn+만/jxc+은/jxc
아니다.	아니/paa+다/ef+./sf
국내업체들이	국내/ncn+업체/ncn+들/xsn+이/jcs
물건을	물건/ncn+을/jco
내놓기만	내/pvg+어/ecs+놓/pvg+기/etn+만/jxc
하면	하/pvg+면/ecs
팔리던	팔리/pvg+던/etm
시절에	시절/ncn+에/jca
젖어있는	젖/pvg+어/ecx+있/px+는/etm
틈을	틈/ncn+을/jco
타	타/pvg+아/ecs
외제품이	외제/ncn+품/xsn+이/jcs
마구	마구/mag
들어오고	들/pvg+어/ecs+오/pvg+고/ecs
거부감도	거부/ncn+감/xsn+도/jxc
줄어들면서	줄/pvg+어/ecx+들/px+면서/ecs
외제품은	외제/ncn+품/xsn+은/jxc
일상생활에	일상/ncn+생활/ncn+에/jca
깊숙히	깊숙/ncn+히/xsa
파고	파/pvg+고/ecc
들었다.	들/pvg+었/ep+다/ef+./sf
시장이	시장/ncn+이/jcs
이처럼	이/npd+처럼/jca
호락호락해	호락호락/mag+하/xsm+어/ecs
보이자	보이/pvg+자/ecs
외국	외국/ncn
다국적	다국/ncn+적/xsn
기업들은	기업/ncn+들/xsn+은/jxc
아예	아예/mag
직영화	직영/ncn+화/xsn
직진출에	직진출/ncn+에/jca
나서고	나서/pvg+고/ecx
있다.	있/px+다/ef+./sf
88올림픽으로	88올림픽/nq+으로/jca
터진	터지/pvg+ㄴ/etm
수입장벽이	수입/ncn+장벽/ncn+이/jcs
불과	불과/mag
10년도	10/nnc+년/nbu+도/jxc
못돼서	못/mag+되/pvg+어서/ecs
유통경로까지	유통/ncn+경로/ncn+까지/jxc
완전히	완전/ncn+히/xsa
무너질	무너지/pvg+ㄹ/etm
판이다.	판/ncn+이/jp+다/ef+./sf
지금까지	지금/ncn+까지/jxc
라이선스	라이선스/ncn
계약이나	계약/ncn+이나/jcj
합작	합작/ncn
등	등/nbn
간접투자방식으로	간접/ncn+투자/ncn+방식/ncn+으로/jca
로열티만	로열티/ncn+만/jxc
챙겨가던	챙기/pvg+어/ecs+가/pvg+던/etm
다국적	다국/ncn+적/xsn
기업들이	기업/ncn+들/xsn+이/jcs
독자법인이나	독자/ncn+법인/ncn+이나/jcj
한국지사를	한국/nq+지사/ncn+를/jco
통해	통하/pvg+어/ecs
직접	직접/mag
영업에	영업/ncn+에/jca
나서	나서/pvg+어/ecs
더	더/mag
많은	많/paa+은/etm
수익을	수익/ncn+을/jco
챙겨가기	챙기/pvg+어/ecs+가/pvg+기/etn
시작한	시작/ncpa+하/xsv+ㄴ/etm
것이다.	것/nbn+이/jp+다/ef+./sf
비교적	비교/ncn+적/xsn
일찍	일찍/mag
시장이	시장/ncn+이/jcs
개방돼	개방/ncpa+되/xsv+어/ecs
국내	국내/ncn
주요	주요/ncn
백화점의	백화/ncn+점/xsn+의/jcm
1층	1/nno+층/nbu
매장을	매장/ncn+을/jco
장악하고	장악/ncpa+하/xsv+고/ecx
있는	있/px+는/etm
외국	외국/ncn
화장품회사들이	화장/ncn+품/xsn+회사/ncn+들/xsn+이/jcs
가장	가장/mag
발빠른	발/ncn+빠르/paa+ㄴ/etm
행보를	행보/ncn+를/jco
보이고	보이/pvg+고/ecx
있다.	있/px+다/ef+./sf
세계	세계/ncn
1위의	1/nno+위/nbu+의/jcm
화장품메이커인	화장/ncn+품/xsn+메이커/ncn+이/jp+ㄴ/etm
로레알그룹이	로레알/nq+그룹/ncn+이/jcs
현지법인	현지/ncn+법인/ncn
코벨을	코벨/nq+을/jco
세워	세우/pvg+어/ecs
비오템	비오템/nq
랑콤	랑콤/nq
로레알파리	로레알파리/nq
등	등/nbn
자사	자사/ncn
브랜드를	브랜드/ncn+를/jco
직접	직접/mag
관리하고	관리/ncpa+하/xsv+고/ecx
있고,	있/px+고/ecc+,/sp
93년	93/nno+년/nbu
태평양과	태평양/nq+과/jct
헤어진	헤어지/pvg+ㄴ/etm
크리스찬디오르를	크리스찬디오르/nq+를/jco
비롯해	비롯/ncpa+하/xsv+어/ecs
에스티	nq[에스티/nq
로더와	로더/nq]nq+와/jcj
크리니크(ELCA코리아),	크리니크/nq+(/sl+nq[ELCA/f+코리아/nq]nq+)/sr+,/sp
엘리자베스	nq[엘리자베스/nq
아덴(유니레버코리아)	아덴/nq]nq+(/sl+유니레버코리아/nq+)/sr
등	등/nbn
쟁쟁한	쟁쟁/ncps+하/xsm+ㄴ/etm
상표들이	상표/ncn+들/xsn+이/jcs
독자	독자/ncn
대열을	대열/ncn+을/jco
이루고	이루/pvg+고/ecx
있다.	있/px+다/ef+./sf
샤넬은	샤넬/nq+은/jxc
화장품	화장/ncn+품/xsn
향수	향수/ncn
컬렉션	컬렉션/ncn
등	등/nbn
품목별로	품목/ncn+별/xsn+로/jca
흩어져있던	흩/pvg+어/ecx+지/px+어/ecx+있/px+던/etm
영업망을	영업/ncn+망/ncn+을/jco
통합해	통합/ncpa+하/xsv+어/ecs
단독	단독/ncn
매장을	매장/ncn+을/jco
냈고,	내/pvg+었ep+고/ecc+,/sp
루이비통코리아는	루이비통코리아/nq+는/jxc
샤넬에	샤넬/nq+에/jca
앞서	앞/ncn+서/pvg+어/ecs
독자	독자/ncn
노선을	노선/ncn+을/jco
걸었다.	걷/pvg+었/ep+다/ef+./sf
일본의	일본/nq+의/jcm
가네보도	가네보/nq+도/jxc
조만간	조만간/mag
한국	한국/nq
파트너와	파트너/ncn+와/jct
관계를	관계/ncn+를/jco
청산할	청산/ncpa+하/xsv+ㄹ/etm
것으로	것/nbn+으로/jca
알려졌다.	알리/pvg+어/ecx+지/px+었/ep+다/ef+./sf
패션업계에서도	패션/ncn+업계/ncn+에서/jca+도/jxc
리바이스코리아,	리바이스코리아/nq+,/sp
컬럼비아코리아,	컬럼비아코리아/nq+,/sp
페라가모코리아,	페라가모코리아/nq+,/sp
아디다스코리아,	아디다스코리아/nq+,/sp
나이키스포츠	나이키스포츠/nq
등으로	등/nbn+으로/jca
이름을	이름/ncn+을/jco
바꾼	바꾸/pvg+ㄴ/etm
해외업체들이	해외/ncn+업체/ncn+들/xsn+이/jcs
늘고	늘/pvg+고/ecx
있다.	있/px+다/ef+./sf
초기엔	초기/ncn+에/jca+ㄴ/jxc
한국의	한국/nq+의/jcm
화승과	화승/nq+과/jct
라이센스	라이센스/ncn
계약을	계약/ncn+을/jco
맺었다가	맺/pvg+었/ep+다가/ecs
지분을	지분/ncn+을/jco
늘려	늘리/pvg+어/ecs
80%까지	80/nnc+%/su+까지/jxc
확보한	확보/ncpa+하/xsv+ㄴ/etm
한국리복의	한국리복/nq+의/jcm
예처럼	예/ncn+처럼/jxc
국내	국내/ncn
시장	시장/ncn
반응에	반응/ncn+에/jca
따라	따르/pvg+아/ecs
점진적으로	점진/ncn+적/xsn+으로/jca
직접	직접/mag
투자	투자/ncn
비율을	비율/ncn+을/jco
높이는	높이/pvg+는/etm
업체들도	업체/ncn+들/xsn+도/jxc
많다.	많/paa+다/ef+./sf
패스트푸드업계에서는	패스트푸드/ncn+업계/ncn+에서/jca+는/jxc
코카콜라가	코카콜라/nq+가/jcs
지분	지분/ncn
회수시비로	회수/ncn+시비/ncn+로/jca
법정까지	법정/ncn+까지/jxc
갔고,	가/pvg+았/ep+고/ecc+,/sp
피자헛처럼	피자헛/nq+처럼/jca
일찌감치	일찌감치/mag
합작	합작/ncn
관계를	관계/ncn+를/jco
정리한	정리/ncpa+하/xsv+ㄴ/etm
곳도	곳/ncn+도/jxc
있다.	있/paa+다/ef+./sf
국내	국내/ncn
통신시장이	통신/ncn+시장/ncn+이/jcs
커지면서	커지/pvg+면서/ecs
이	이/mmd
분야에서도	분야/ncn+에서/jca+도/jxc
합작을	합작/ncn+을/jco
청산하고	청산/ncpa+하/xsv+고/ecs
직접	직접/mag
진출로	진출/ncn+로/jca
돌아서는	돌/pvg+아/ecs+서/pvg+는/etm
외국	외국/ncn
기업들이	기업/ncn+들/xsn+이/jcs
적지않다.	적/paa+지/ecx+않/px+다/ef+./sf
합작	합작/ncn
경험을	경험/ncn+을/jco
바탕으로	바탕/ncn+으로/jca
한국	한국/nq
시장을	시장/ncn+을/jco
알만큼	알/pvg+ㄹ/etm+만큼/nbn
안다는	알/pvg+ㄴ다/ef+는/etm
자신감이	자신/ncn+감/xsn+이/jcs
생긴	생기/pvg+ㄴ/etm
것이다.	것/nbn+이/jp+다/ef+./sf
대표적인	대표/ncn+적/xsn+이/jp+ㄴ/etm
기업이	기업/ncn+이/jcs
세계	세계/ncn
통신장비	통신/ncn+장비/ncn
시장을	시장/ncn+을/jco
이끄는	이끌/pvg+는/etm
미국의	미국/nq+의/jcm
통신장비업체	통신/ncn+장비/ncn+업체/ncn
루슨트테크놀로지와	루슨트테크놀로지/nq+와/jcj
스웨덴의	스웨덴/nq+의/jcm
에릭슨이며,	에릭슨/nq+이/jp+며/ecc+,/sp
이밖에	이/npd+밖에/jxc
프랑스의	프랑스/nq+의/jcm
알카텔,	알카텔/nq+,/sp
캐나다의	캐나다/nq+의/jcm
노던텔레콤	노던텔레콤/nq
등	등/nbn
세계	세계/ncn
5위권	5/nno+위/nbu+권/xsn
안팎의	안팎/ncn+의/jcm
기업들도	기업/ncn+들/xsn+도/jxc
최근	최근/ncn
국내	국내/ncn
시장에	시장/ncn+에/jca
직접	직접/mag
진출하고	진출/ncpa+하/xsv+고/ecx
있다.	있/px+다/ef+./sf
루슨트테크놀로지는	루슨트테크놀로지/nq+는/jxc
80년대부터	80/nno+년대/nbu+부터/jxc
금성정보통신(현재	금성정보통신/nq+(/sl+현재/ncn
엘지정보통신)과	엘지정보통신/nq+)/sr+과/jct
합작으로	합작/ncn+으로/jca
국내에서	국내/ncn+에서/jca
교환기를	교환/ncn+기/xsn+를/jco
생산했으나,	생산/ncpa+하/xsv+었/ep+으나/ecs+,/sp
94년	94/nno+년/nbu
합작	합작/ncn
관계를	관계/ncn+를/jco
완전히	완전/ncn+히/xsa
청산하고	청산/ncpa+하/xsv+고/ecs
직접	직접/mag
진출해	진출/ncpa+하/xsv+어/ecs
지난해	지나/pvg+ㄴ/etm+해/ncn
2억달러	2억/nnc+달러/nbu
정도의	정도/ncn+의/jcm
적지않은	적/paa+지/ecx+않/px+은/etm
매출을	매출/ncn+을/jco
올렸다	올리/pvg+었/ep+다/ef
국내	국내/ncn
교환기	교환/ncn+기/xsn
시장은	시장/ncn+은/jxc
삼성전자,	삼성전자/nq+,/sp
엘지정보통신,	엘지정보통신/nq+,/sp
대우통신,	대우통신/nq+,/sp
한화전자정보통신	한화전자정보통신/nq
등	등/nbn
4개	4/nnc+개/nbu
업체가	업체/ncn+가/jcs
이끌었는데,	이끌/pvg+었/ep+는데/ecs+,/sp
루슨트테크놀로지가	루슨트테크놀로지/nq+가/jcs
등장하면서	등장/ncpa+하/xsv+면서/ecs
5개	5/nnc+개/nbu
업체가	업체/ncn+가/jcs
균점하는	균점/ncpa+하/xsv+는/etm
구도로	구도/ncn+로/jca
바뀌었다.	바뀌/pvg+었/ep+다/ef+./sf
에릭슨은	에릭슨/nq+은/jxc
82년	82/nno+년/nbu
국내에	국내/ncn+에/jca
지사를	지사/ncn+를/jco
세우고	세우/pvg+고/ecc
83년	83/nno+년/nbu
동양정밀(현재의	동양정밀/nq+(/sl+현재/ncn+의/jcm
한화전자정보통신)과	한화전자정보통신/nq+)/sr+과/jcj
`오텔코'라는	`/sl+오텔코/nq+'/sr+라/ef+는/etm
통신장비	통신/ncn+장비/ncn
업체를	업체/ncn+를/jco
함께	함께/mag
만들어	만들/pvg+어/ecs
교환기를	교환/ncn+기/xsn+를/jco
국내에서	국내/ncn+에서/jca
생산했으나,	생산/ncpa+하/xsv+었/ep+으나/ecs+,/sp
90년대	90/nno+년대/nbu
초	초/ncn
합작	합작/ncn
관계를	관계/ncn+를/jco
청산하고	청산/ncpa+하/xsv+고/ecc
92년	92/nno+년/nbu
현지법인을	현지/ncn+법인/ncn+을/jco
세우면서	세우/pvg+면서/ecs
직접	직접/mag
진출로	진출/ncn+로/jca
방향을	방향/ncn+을/jco
바꿨다.	바꾸/pvg+었/ep+다/ef+./sf
국제전화용	국제/ncn+전화/ncn+용/xsn
교환기	교환/ncn+기/xsn
분야에서	분야/ncn+에서/jca
루슨트테크놀로지와	루슨트테크놀로지/nq+와/jct
함께	함께/mag
국내	국내/ncn
시장을	시장/ncn+을/jco
나눠먹고	나누/pvg+어/ecx+먹/px+고/ecx
있으며,	있/px+으며/ecc+,/sp
기업용	기업/ncn+용/xsn
무선통신	무선/ncn+통신/ncn
시스템인	시스템/ncn+이/jp+ㄴ/etm
`주파수공용통신'	`/sl+주파/ncn+수/ncn+공용/ncn+통신/ncn+'/sr
장비	장비/ncn
분야에서는	분야/ncn+에서/jca+는/jxc
국내	국내/ncn
시장을	시장/ncn+을/jco
지배하는	지배/ncpa+하/xsv+는/etm
상태다.	상태/ncn+다/ef+./sf
무선데이터통신	무선/ncn+데이터/ncn+통신/ncn
장비	장비/ncn
분야에서도	분야/ncn+에서/jca+도/jxc
국내	국내/ncn
업체에	업체/ncn+에/jca
최근	최근/ncn
납품을	납품/ncn+을/jco
하는	하/pvg+는/etm
등	등/nbn
사업	사업/ncn
본격화하고	본격/ncn+화/xsn+하/xsv+고/ecx
있다.	있/px+다/ef+./sf
자동차	자동/ncn+차/ncn
업계도	업계/ncn+도/jxc
판매부진을	판매/ncn+부진/ncn+을/jco
견디다	견디/pvg+다/ecs
못한	못하/px+ㄴ/etm
수입대행사쪽이	수입/ncn+대행/ncn+사/xsn+쪽/nbn+이/jcs
손을	손/ncn+을/jco
털자	털/pvg+자/ecs
제너럴모터스,	제너럴모터스/nq+,/sp
도요다,	도요다/nq+,/sp
스즈키	스즈키/nq
등	등/nbn
외국업체들이	외국/ncn+업체/ncn+들/xsn+이/jcs
직영화를	직영/ncn+화/xsn+를/jco
서두르고	서두르/pvg+고/ecx
있다.	있/px+다/ef+./sf
외국업체들이	외국/ncn+업체/ncn+들/xsn+이/jcs
이처럼	이/npd+처럼/jca
직영에	직영/ncn+에/jca
나서는	나서/pvg+는/etm
것은	것/nbn+은/jxc
까르띠에처럼	까르띠에/nq+처럼/jca
글로벌메이커	글로벌메이커/ncn
전략에	전략/ncn+에/jca
따라	따르/pvg+아/ecs
전세계	전/mma+세계/ncn
모든	모든/mma
지역에서	지역/ncn+에서/jca
일관된	일관/ncpa+되/xsv+ㄴ/etm
제품	제품/ncn
이미지를	이미지/ncn+를/jco
관리하려는	관리/ncpa+하/xsv+려/ecs+는/etm
의도이거나	의도/ncn+이/jp+거나/ecc
국내	국내/ncn
합작선과의	합작/ncn+선/ncn+과/jct+의/jcm
갈등	갈등/ncn
탓이	탓/ncn+이/jcs
대부분이다.	대부분/ncn+이/jp+다/ef+./sf
어떤	어떤/mmd
경우든	경우/ncn+든/jxc
그들이	그/npp+들/xsn+이/jcs
우리	우리/npp
소비자와	소비/ncn+자/xsn+와/jct
직접	직접/mag
대면을	대면/ncn+을/jco
할	하/pvg+ㄹ/etm
만큼	만큼/nbn
자신감을	자신/ncn+감/xsn+을/jco
갖고	갖/pvg+고/ecx
있다는	있/px+다/ef+는/etm
것은	것/nbn+은/jxc
분명하다.	분명/ncps+하/xsm+다/ef+./sf
프랑스계	프랑스/nq+계/xsn
할인점	할인/ncn+점/xsn
카르푸는	카르푸/nq+는/jxc
매장을	매장/ncn+을/jco
3개를	3/nnc+개/nbu+를/jco
내년	내년/ncn
중	중/nbn
9개로	9/nnc+개/nbu+로/jca
늘릴	늘리/pvg+ㄹ/etm
방침이다.	방침/ncn+이/jp+다/ef+./sf
다국적	다국/ncn+적/xsn
기업	기업/ncn
최고	최고/ncn
경영자들의	경영/ncn+자/xsn+들/xsn+의/jcm
인터뷰	인터뷰/ncn
기사에서	기사/ncn+에서/jca
그들의	그/npp+들/xsn+의/jcm
솔직한	솔직/ncps+하/xsm+ㄴ/etm
대답을	대답/ncn+을/jco
확인할	확인/ncpa+하/xsv+ㄹ/etm
수	수/nbn
있다.	있/paa+다/ef+./sf
몇해	몇/mma+해/ncn
전	전/ncn
국내	국내/ncn
운동화업체가	운동화/ncn+업체/ncn+가/jcs
내건	내/pvg+어/ecs+걸/pvg+ㄴ/etm
광고	광고/ncn
카피는	카피/ncn+는/jxc
지금	지금/mag
막강한	막강/ncps+하/xsm+ㄴ/etm
자금력과	자금/ncn+력/xsn+과/jcj
유통	유통/ncn
노하우로	노하우/ncn+로/jca
국내	국내/ncn
시장에	시장/ncn+에/jca
직접	직접/mag
파고	파/pvg+고/ecx
들고	들/px+고/ecx
있는	있/px+는/etm
다국적	다국/ncn+적/xsn
기업들의	기업/ncn+들/xsn+의/jcm
공격에	공격/ncn+에/jca
직면한	직면/ncpa+하/xsv+ㄴ/etm
우리	우리/npp
기업들의	기업/ncn+들/xsn+의/jcm
운명을	운명/ncn+을/jco
예고하고	예고/ncpa+하/xsv+고/ecx
있다.	있/px+다/ef+./sf
그동안	그/mmd+동안/ncn
눈앞의	눈앞/ncn+의/jcm
이익에	이익/ncn+에/jca
급급해	급급/ncps+하/xsm+어/ecs
외국	외국/ncn
완제품을	완제/ncn+품/xsn+을/jco
들여오기에	들이/pvg+어/ecs+오/pvg+기/etn+에/jca
바빴던	바쁘/paa+았/ep+던/etm
국내	국내/ncn
업체들은	업체/ncn+들/xsn+은/jxc
이제	이제/mag
스스로	스스로/mag
개척한	개척/ncpa+하/xsv+ㄴ/etm
유통망까지	유통/ncn+망/ncn+까지/jxc
통째로	통째/ncn+로/jca
내주고	내/pvg+어/ecs+주/pvg+고/ecs
용도폐기될	용도/ncn+폐기/ncpa+되/xsv+ㄹ/etm
처지에	처지/ncn+에/jca
놓여	놓이/pvg+어/ecx
있는	있/px+는/etm
것이	것/nbn+이/jcs
사실이다.	사실/ncn+이/jp+다/ef+./sf
그러나	그러나/maj
끝까지	끝/ncn+까지/jxc
포기하지	포기/ncpa+하/xsv+지/ecx
않고	않/px+고/ecc
정면	정면/ncn
대응한	대응/ncpa+하/xsv+ㄴ/etm
기업들도	기업/ncn+들/xsn+도/jxc
적지	적/paa+지/ecx
않다.	않/px+다/ef+./sf
국제상사의	국제상사/nq+의/jcm
프로스펙스나	프로스펙스/nq+나/jcj
화승의	화승/nq+의/jcm
르까프는	르까프/nq+는/jxc
외국	외국/ncn
브랜드	브랜드/ncn
도입에	도입/ncn+에/jca
연연하지	연연/ncpa+하/xsv+지/ecx
않고	않/px+고/ecc
품질과	품질/ncn+과/jcj
기술력을	기술/ncn+력/xsn+을/jco
키워	키우/pvg+어/ecs
국내	국내/ncn
시장에서	시장/ncn+에서/jca
나이키	나이키/nq
아디다스	아디다스/nq
리복	리복/nq
등	등/nbn
수입품과	수입/ncn+품/xsn+과/jct
대등한	대등/ncps+하/xsm+ㄴ/etm
경쟁을	경쟁/ncn+을/jco
하고	하/pvg+고/ecx
있다.	있/px+다/ef+./sf
리바이스	리바이스/nq
리	리/nq
게스	게스/nq
캘빈클라인	캘빈클라인/nq
등	등/nbn
세계적인	세계/ncn+적/xsn+이/jp+ㄴ/etm
진의	진/ncn+의/jcm
대명사들이	대명사/ncn+들/xsn+이/jcs
유독	유독/mag
한국시장에서는	한국/nq+시장/ncn+에서/jca+는/jxc
활개를	활개/ncn+를/jco
펴지	펴/pvg+지/ecx
못하고	못하/px+고/ecx
있다	있/px+다/ef
10만원	10만/nnc+원/nbu
이상의	이상/ncn+의/jcm
고가전략으로	고가/ncn+전략/ncn+으로/jca
맞대응한	맞대응/ncpa+하/xsv+ㄴ/etm
닉스의	닉스/nq+의/jcm
돌풍에	돌풍/ncn+에/jca
힘입어	힘/ncn+입/pvg+어/ecs
베이직	베이직/nq
스톰	스톰/nq
GV2	nq[GV/f+2/nnc]nq
YAH	YAH/f
등	등/nbn
국산	국산/ncn
제품들이	제품/ncn+들/xsn+이/jcs
우리	우리/npp
젊은이들에	젊은이/ncn+들/xsn+에/jca
맞는	맞/pvg+는/etm
감각으로	감각/ncn+으로/jca
선전을	선전/ncn+을/jco
하고	하/pvg+고/ecx
있다.	있/px+다/ef+./sf
신세대	신/xp+세대/ncn
취향의	취향/ncn+의/jcm
크래커	크래커/ncn
`제크'를	`/sl+제크/nq+'/sr+를/jco
개발해	개발/ncpa+하/xsv+어/ecs
미국	미국/nq
나비스코사의	나비스코사/nq+의/jcm
`리츠'를	`/sl+리츠/nq+'/sr+를/jco
수퍼마켓의	수퍼마켓/ncn+의/jcm
진열대에서	진열/ncn+대/ncn+에서/jca
밀려나게한	밀리/pvg+어/ecx+나/px+게/ecx+하/px+ㄴ/etm
롯데제과의	롯데제과/nq+의/jcm
진검	진검/ncn
승부는	승부/ncn+는/jxc
업계에	업계/ncn+에/jca
좋은	좋/paa+은/etm
자극제가	자극/ncn+제/xsn+가/jcs
되고	되/pvg+고/ecx
있다.	있/px+다/ef+./sf
태평양이	태평양/nq+이/jcs
프랑스의	프랑스/nq+의/jcm
현지공장에서	현지/ncn+공장/ncn+에서/jca
생산해	생산/ncpa+하/xsv+어/ecs
백화점	백화/ncn+점/xsn
전용	전용/ncn
브랜드로	브랜드/ncn+로/jca
키우고	키우/pvg+고/ecx
있는	있/px+는/etm
고기능성	고/xp+기능/ncn+성/xsn
화장품	화장/ncn+품/xsn
`리리코스'의	`/sl+리리코스/nq+'/sr+의/jcm
성공	성공/ncn
사례나,	사례/ncn+나/ecc+,/sp
애경산업이	애경산업/nq+이/jcs
프랑스로부터	프랑스/nq+로/jca+부터/jxc
상표만	상표/ncn+만/jxc
들여와	들이/pvg+어/ecs+오/pvg+아/ecs
만든	만들/pvg+ㄴ/etm
`마리	`/sl+nq[마리/nq
끌레르'	끌레르/nq]nq+'/sr
화장품을	화장/ncn+품/xsn+을/jco
역수출하고	역/xp+수출/ncpa+하/xsv+고/ecx
있는	있/px+는/etm
것은	것/nbn+은/jxc
해외업체들의	해외/ncn+업체/ncn+들/xsn+의/jcm
공세에	공세/ncn+에/jca
우회적인	우회/ncn+적/xsn+이/jp+ㄴ/etm
방법으로	방법/ncn+으로/jca
대응한	대응/ncpa+하/xsv+ㄴ/etm
경우에	경우/ncn+에/jca
속한다.	속하/pvg+ㄴ다/ef+./sf
전문가들은	전문/ncn+가/xsn+들/xsn+은/jxc
글로벌브랜드를	글로벌브랜드/ncn+를/jco
추구하는	추구/ncpa+하/xsv+는/etm
다국적기업들은	다국/ncn+적/xsn+기업/ncn+들/xsn+은/jxc
전세계	전/mma+세계/ncn
어디서나	어디/npd+서/jca+나/jxc
보편적으로	보편/ncn+적/xsn+으로/jca
팔릴	팔리/pvg+ㄹ/etm
수	수/nbn
있는	있/paa+는/etm
제품을	제품/ncn+을/jco
만들기	만들/pvg+기/etn
때문에	때문/nbn+에/jca
우리	우리/npp
소비자들만의	소비/ncn+자/xsn+들/xsn+만/jxc+의/jcm
욕구를	욕구/ncn+를/jco
채워줄	채우/pvg+어/ecx+주/px+ㄹ/etm
수	수/nbn
없는	없/paa+는/etm
허점도	허점/ncn+도/jxc
있다고	있/paa+다/ef+고/jcr
지적한다.	지적/ncpa+하/xsv+ㄴ다/ef+./sf
전세계	전/mma+세계/ncn
텔레비전시장을	텔레비전/ncn+시장/ncn+을/jco
석권하고	석권/ncpa+하/xsv+고/ecx
있는	있/px+는/etm
소니가	소니/nq+가/jcs
한국	한국/nq
소비자들만을	소비/ncn+자/xsn+들/xsn+만/jxc+을/jco
위해	위하/pvg+어/ecs
음성다중	음성/ncn+다중/ncn
제품을	제품/ncn+을/jco
개발하기	개발/ncpa+하/xsv+기/etn
어려운	어렵/paa+ㄴ/etm
것이	것/nbn+이/jcs
전형적인	전형/ncn+적/xsn+이/jp+ㄴ/etm
예이다.	예/ncn+이/jp+다/ef+./sf
김치	김치/ncn
냉장고나	냉장고/ncn+나/jxc
찌든	찌들/pvg+ㄴ/etm
때를	때/ncn+를/jco
제거하는	제거/ncpa+하/xsv+는/etm
세탁기,	세탁/ncn+기/xsn+,/sp
오목한	오목/ncps+하/xsm+ㄴ/etm
그릇까지	그릇/ncn+까지/jxc
씻어주는	씻/pvg+어/ecx+주/px+는/etm
식기세척기	식기/ncn+세척/ncn+기/xsn
등	등/nbn
국산	국산/ncn
가전제품이	가전/ncn+제품/ncn+이/jcs
우리	우리/npp
생활습관에	생활/ncn+습관/ncn+에/jca
맞는	맞/pvg+는/etm
제품으로	제품/ncn+으로/jca
호응을	호응/ncn+을/jco
얻고	얻/pvg+고/ecx
있다.	있/px+다/ef+./sf
요즘	요즘/mag
들어	들/pvg+어/ecs
우리나라	우리/npp+나라/ncn
대부분의	대부분/ncn+의/jcm
기업이	기업/ncn+이/jcs
선진국	선진/ncn+국/xsn
기업들과	기업/ncn+들/xsn+과/jct
같이	같/paa+이/xsa
직원들에게	직원/ncn+들/xsn+에게/jca
연월차를	연월차/ncn+를/jco
강제로	강제/ncn+로/jca
쓰게	쓰/pvg+게/ecx
하고	하/px+고/ecx
있다.	있/px+다/ef+./sf
기업	기업/ncn
사정이	사정/ncn+이/jcs
어려워지자	어렵/paa+어/ecx+지/px+자/ecs
경비	경비/ncn
절감을	절감/ncn+을/jco
꾀해보려는	꾀하/pvg+어/ecx+보/px+려/ecs+는/etm
속사정이	속/ncn+사정/ncn+이/jcs
그	그/mmd
뒤쪽에	뒤/ncn+쪽/nbn+에/jca
깔려	깔리/pvg+어/ecx
있다.	있/px+다/ef+./sf
사실	사실/mag
선진국	선진/ncn+국/xsn
기업들이	기업/ncn+들/xsn+이/jcs
직원들로	직원/ncn+들/xsn+로/jca
하여금	하여금/mag
강제로	강제/ncn+로/jca
휴가를	휴가/ncn+를/jco
가도록	가/pvg+도록/ecs
하는	하/px+는/etm
데에는	데/nbn+에/jca+는/jxc
우리	우리/npp
기업들과는	기업/ncn+들/xsn+과/jct+는/jxc
다른	다르/paa+ㄴ/etm
명백하고도	명백/ncps+하/xsm+고도/ecs
합리적인	합리/ncn+적/xsn+이/jp+ㄴ/etm
이유가	이유/ncn+가/jcs
있다.	있/paa+다/ef+./sf
우선	우선/mag
해당	해당/ncn
직원이	직원/ncn+이/jcs
빠지더라도	빠지/pvg+더라도/ecs
업무가	업무/ncn+가/jcs
잘	잘/mag
돌아가는지	돌/pvg+아/ecx+가/px+는지/ecs
살피는	살피/pvg+는/etm
등	등/nbn
조직	조직/ncn
관리와	관리/ncn+와/jcj
시스템에	시스템/ncn+에/jca
대한	대하/pvg+ㄴ/etm
`건강	`/sl+건강/ncn
검진'을	검진/ncn+'/sr+을/jco
하게	하/pvg+게/ecs
된다.	되/pvg+ㄴ다/ef+./sf
아울러	아울러/mag
상급자는	상급/ncn+자/xsn+는/jxc
담당자가	담당/ncn+자/xsn+가/jcs
없는	없/paa+는/etm
동안에	동안/ncn+에/jca
혹시	혹시/mag
그	그/mmd
자리에	자리/ncn+에/jca
부정부패의	부정/ncn+부패/ncn+의/jcm
요소가	요소/ncn+가/jcs
있었는지를	있/paa+었/ep+는지/ecs+를/jco
점검한다.	점검/ncpa+하/xsv+ㄴ다/ef+./sf
이를	이/npd+를/jco
주요	주요/ncn
자리(포스트)마다	자리/ncn+(/sl+포스트/ncn+)/sr+마다/jxc
행하게	행하/pvg+게/ecs
된다.	되/pvg+ㄴ다/ef+./sf
이러한	이러하/pad+ㄴ/etm
휴가	휴가/ncn
실시가	실시/ncn+가/jcs
직원들에게	직원/ncn+들/xsn+에게/jca
재충전(리프레시)을	재/xp+충전/ncn+(/sl+리프레시/ncn+)/sr+을/jco
위한	위하/pvg+ㄴ/etm
배려일	배려/ncn+이/jp+ㄹ/etm
수도	수/nbn+도/jxc
있다.	있/paa+다/ef+./sf
하지만	하지만/maj
그보다는	그/npd+보다/jca+는/jxc
사전	사전/ncn
예방과	예방/ncn+과/jcj
사후	사후/ncn
검사조처를	검사/ncn+조처/ncn+를/jco
체계적으로	체계/ncn+적/xsn+으로/jca
하는	하/pvg+는/etm
내부통제수단으로서	내부/ncn+통제/ncn+수단/ncn+으로서/jca
용도가	용도/ncn+가/jcs
더	더/mag
크다.	크/paa+다/ef+./sf
조직에	조직/ncn+에/jca
늘	늘/mag
긴장을	긴장/ncn+을/jco
불러일으키고자	부르/pvg+어/ecs+일으키/pvg+고자/ecs
한다.	하/px+ㄴ다/ef+./sf
몇년	몇/mma+년/nbu
전	전/ncn
싱가포르에서	싱가포르/nq+에서/jca
근무하는	근무/ncpa+하/xsv+는/etm
한	한/nnc
실무자가	실무/ncn+자/xsn+가/jcs
환투기를	환투기/ncn+를/jco
잘못하는	잘못/mag+하/xsv+는/etm
바람에	바람/nbn+에/jca
300년	300/nnc+년/nbu
역사의	역사/ncn+의/jcm
베어링	nq[베어링/nq
투자은행이	투자/ncn+은행/ncn]nq+이/jcs
하루아침에	하루/ncn+아침/ncn+에/jca
무너지고	무너지/pvg+고/ecx
말았다.	말/px+았/ep+다/ef+./sf
상급자가	상급/ncn+자/xsn+가/jcs
부하	부하/ncn
직원에	직원/ncn+에/jca
대한	대하/pvg+ㄴ/etm
감시를	감시/ncn+를/jco
소홀히	소홀/ncn+히/xsa
하는	하/pvg+는/etm
바람에	바람/nbn+에/jca
이런	이런/mmd
창구사고가	창구/ncn+사고/ncn+가/jcs
터져버린	터지/pvg+어/ecx+버리/px+ㄴ/etm
것이다.	것/nbn+이/jp+다/ef+./sf
왜	왜/mag
우리나라	우리/npp+나라/ncn
기업들에서는	기업/ncn+들/xsn+에서/jca+는/jxc
이러한	이러하/pad+ㄴ/etm
내부통제장치가	내부/ncn+통제/ncn+장치/ncn+가/jcs
잘	잘/mag
작동하지	작동/ncpa+하/xsv+지/ecx
않고	않/px+고/ecx
있는	있/px+는/etm
것일까.	것/nbn+이/jp+ㄹ까/ef+./sf
소유	소유/ncn
경영주와	경영/ncn+주/xsn+와/jcj
피고용	피/xp+고용/ncn
경영간부	경영/ncn+간부/ncn
사이에	사이/ncn+에/jca
맞물린	맞물리/pvg+ㄴ/etm
일종의	일종/ncn+의/jcm
부정,	부정/ncn+,/sp
탈법행위가	탈법/ncn+행위/ncn+가/jcs
먹이사슬로서	먹이/ncn+사슬/ncn+로서/jca
서로	서로/mag
옴짝달싹하지	옴짝달싹/mag+하/xsv+지/ecx
못하게	못하/px+게/ecs
묶고	묶/pvg+고/ecx
있기	있/px+기/etn
때문이	때문/nbn+이/jcc
아닐까.	아니/paa+ㄹ까/ef+./sf
투자원본을	투자/ncn+원본/ncn+을/jco
최대한	최대한/ncn
회수해보려는	회수/ncpa+하/xsv+어/ecx+보/px+려/ecs+는/etm
동기	동기/ncn
요인이	요인/ncn+이/jcs
강하게	강하/paa+게/ecs
작용하는	작용/ncpa+하/xsv+는/etm
소유	소유/ncn
경영주의	경영/ncn+주/xsn+의/jcm
경우	경우/ncn
현재로선	현재/ncn+로서/jca+ㄴ/jxc
달리	다르/paa+이/xsa
투자자금을	투자/ncn+자금/ncn+을/jco
빼낼	빼/pvg+어/ecs+내/pvg+ㄹ/etm
수	수/nbn
있는	있/paa+는/etm
방법이	방법/ncn+이/jcs
불충분하기	불/xp+충분/ncps+하/xsm+기/etn
때문에	때문/nbn+에/jca
비용	비용/ncn
처리나	처리/ncn+나/jcj
비자금	비자금/ncn
조성	조성/ncn
등과	등/nbn+과/jct
같은	같/paa+은/etm
불건전한	불/xp+건전/ncps+하/xsm+ㄴ/etm
방법을	방법/ncn+을/jco
동원하게	동원/ncpa+하/xsv+게/ecs
된다.	되/pvg+ㄴ다/ef+./sf
개인적인	개인/ncn+적/xsn+이/jp+ㄴ/etm
축재	축재/ncn
동기가	동기/ncn+가/jcs
더해지면	더하/pvg+어/ecx+지/px+면/ecs
여느	여느/mma
주주들과는	주주/ncn+들/xsn+과/jct+는/jxc
다른	다르/paa+ㄴ/etm
더욱	더욱/mag
차별적인	차별/ncn+적/xsn+이/jp+ㄴ/etm
대우를	대우/ncn+를/jco
원하게	원하/pvg+게/ecs
된다.	되/pvg+ㄴ다/ef+./sf
경영상	경영/ncn+상/xsn
불가피하다고	불가피/ncps+하/xsm+다/ef+고/jcr
여기는	여기/pvg+는/etm
경우도	경우/ncn+도/jxc
있다.	있/paa+다/ef+./sf
가령	가령/mag
부도를	부도/ncn+를/jco
막으려고	막/pvg+으려고/ecs
사채를	사채/ncn+를/jco
끌어쓰다	끌/pvg+어/ecs+쓰/pvg+다/ecs
보니	보/px+니/ecs
이를	이/npd+를/jco
장부외	장부/ncn+외/nbn
처리해야	처리/ncpa+하/xsv+어야/ecs
하는	하/px+는/etm
등	등/nbn
경영상	경영/ncn+상/xsn
탈법을	탈법/ncn+을/jco
저지르게	저지르/pvg+게/ecs
된다.	되/pvg+ㄴ다/ef+./sf
이런	이런/mmd
것들이	것/nbn+들/xsn+이/jcs
쌓이다	쌓이/pvg+다/ecs
보니	보/px+니/ecs
혹시나	혹시/mag+나/jxc
자신들의	자신/ncn+들/xsn+의/jcm
약점이	약점/ncn+이/jcs
드러날까	드러나/pvg+ㄹ까/ef
우려해	우려/ncpa+하/xsv+어/ecs
내부통제장치를	내부/ncn+통제/ncn+장치/ncn+를/jco
강하게	강하/paa+게/ecx
하지	하/px+지/ecx
못한다.	못하/px+ㄴ다/ef+./sf
겉으로는	겉/ncn+으로/jca+는/jxc
효율화와	효율/ncn+화/xsn+와/jcj
합리화를	합리/ncn+화/xsn+를/jco
외치며	외치/pvg+며/ecs
예산	예산/ncn
절약에	절약/ncn+에/jca
열을	열/ncn+을/jco
올려도	올리/pvg+어도/ecs
결국	결국/mag
회사	회사/ncn
내부에서	내부/ncn+에서/jca
통제가	통제/ncn+가/jcs
안되면	안되/paa+면/ecs
아무런	아무렇/pad+ㄴ/etm
효과가	효과/ncn+가/jcs
없다.	없/paa+다/ef+./sf
우리	우리/npp
기업들의	기업/ncn+들/xsn+의/jcm
의식구조가	의식/ncn+구조/ncn+가/jcs
이런	이런/mmd
수준에	수준/ncn+에/jca
머무르고	머무르/pvg+고/ecx
있는	있/px+는/etm
사이에	사이/ncn+에/jca
외부	외부/ncn
여건은	여건/ncn+은/jxc
크게	크/paa+게/ecs
변하고	변하/pvg+고/ecx
있다.	있/px+다/ef+./sf
첫째,	첫째/nno+,/sp
외국인	외국/ncn+인/xsn
투자와	투자/ncn+와/jcj
시장	시장/ncn
개방화가	개방/ncn+화/xsn+가/jcs
진전하면서	진전/ncpa+하/xsv+면서/ecs
재무정보	재무/ncn+정보/ncn
공시	공시/ncn
등	등/nbn
경영	경영/ncn
투명성을	투명/ncn+성/xsn+을/jco
높이려는	높이/pvg+려/ecs+는/etm
욕구와	욕구/ncn+와/jcj
목소리가	목소리/ncn+가/jcs
커져가고	커지/pvg+어/ecx+가/px+고/ecx
있다.	있/px+다/ef+./sf
둘째,	둘째/nno+,/sp
우루과이라운드와	우루과이라운드/nq+와/jcj
세계무역기구에	세계무역기구/nq+에/jca
이어	잇/pvg+어/ecs
이른바	이른바/maj
부패라운드가	부패/ncn+라운드/ncn+가/jcs
기업	기업/ncn
내부에	내부/ncn+에/jca
만연한	만연/ncpa+하/xsv+ㄴ/etm
부정부패를	부정/ncn+부패/ncn+를/jco
축출하고자	축출/ncpa+하/xsv+고자/ecs
큰	크/paa+ㄴ/etm
물결로	물결/ncn+로/jca
다가오고	다가오/pvg+고/ecx
있다.	있/px+다/ef+./sf
여기에	여기/npd+에/jca
제대로	제대로/mag
대처하지	대처/ncpa+하/xsv+지/ecx
못한다면	못하/px+ㄴ다/ef+면/ecs
국제경쟁에서	국제/ncn+경쟁/ncn+에서/jca
또	또/mag
한	한/nnc
번	번/nbu
쓰러지는	쓰러지/pvg+는/etm
경험을	경험/ncn+을/jco
하게	하/pvg+게/ecs
된다.	되/pvg+ㄴ다/ef+./sf
지금까지는	지금/ncn+까지/jxc+는/jxc
시장경쟁으로	시장/ncn+경쟁/ncn+으로/jca
쓰러져	쓰러지/pvg+어/ecx
왔지만,	오/px+았/ep+지만/ecs+,/sp
이제부터는	이제/ncn+부터/jxc+는/jxc
내부통제가	내부/ncn+통제/ncn+가/jcs
갖춰지지	갖추/pvg++어/ecx+지/px+지/ecx
않아	않/px+아/ecs
경영	경영/ncn
투명성을	투명/ncn+성/xsn+을/jco
확보하지	확보/ncpa+하/xsv+지/ecx
못해서	못하/px+어서/ecs
쓰러지게	쓰러지/pvg+게/ecs
된다.	되/pvg+ㄴ다/ef+./sf
우리	우리/npp
기업들은	기업/ncn+들/xsn+은/jxc
자생력	자생/ncn+력/xsn
강화의	강화/ncn+의/jcm
하나로	하나/ncn+로/jca
내부통제를	내부/ncn+통제/ncn+를/jco
강화할	강화/ncpa+하/xsv+ㄹ/etm
필요성이	필요/ncn+성/xsn+이/jcs
있다.	있/paa+다/ef+./sf
이는	이/npd+는/jxc
제도적으로	제도/ncn+적/xsn+으로/jca
회계처리기준을	회계/ncn+처리/ncn+기준/ncn+을/jco
강화하거나	강화/ncpa+하/xsv+거나/ecc
탈법행위	탈법/ncn+행위/ncn
감리와	감리/ncn+와/jcj
처벌을	처벌/ncn+을/jco
강화한다고	강화/ncpa+하/xsv+ㄴ다고/ecs
해서	하/px+어서/ecs
해결되지	해결/ncpa+되/xsv+지/ecx
않는다.	않/px+는다/ef+./sf
쌓여온	쌓이/pvg+어/ecx+오/px+ㄴ/etm
폐단으로	폐단/ncn+으로/jca
인해	인하/pvg+어/ecs
새롭게	새롭/paa+게/ecs
움직이기가	움직이/pvg+기/etn+가/jcs
힘든	힘/ncn+들/pvg+ㄴ/etm
상황이다.	상황/ncn+이/jp+다/ef+./sf
죄질이나	죄질/ncn+이나/jcj
양의	양/ncn+의/jcm
과다를	과다/ncn+를/jco
따질	따지/pvg+ㄹ/etm
것이	것/nbn+이/jcs
아니라	아니/paa+라/ecs
한번에	한/nnc+번/nbu+에/jca
털어내어	털/pvg+어/ecs+내/pvg+어/ecs
향후	향후/mag
행동의	행동/ncn+의/jcm
자유를	자유/ncn+를/jco
보장해주어야	보장/ncpa+하/xsv+어/ecx+주/px+어야/ecs
한다.	하/px+ㄴ다/ef+./sf
또	또/maj
세제	세제/ncn
개편을	개편/ncn+을/jco
해서라도	하/pvg+어서/ecs+라도/ecs
소유경영주들에게는	소유/ncn+경영/ncn+주/xsn+들/xsn+에게/jca+는/jxc
불리하지	불리/ncps+하/xsm+지/ecx
않은	않/px+은/etm
시장가격으로	시장/ncn+가격/ncn+으로/jca
투자원본을	투자/ncn+원본/ncn+을/jco
회수할	회수/ncpa+하/xsv+ㄹ/etm
수	수/nbn
있는	있/paa+는/etm
제도적	제도/ncn+적/xsn
장치를	장치/ncn+를/jco
마련해	마련/ncpa+하/xsv+어/ecx
주어야	주/px+어야/ecs
한다.	하/px+ㄴ다/ef+./sf
경영간부에게도	경영/ncn+간부/ncn+에게/jca+도/jxc
봉급을	봉급/ncn+을/jco
깎거나	깎/pvg+거나/ecc
동결할	동결/ncpa+하/xsv+ㄹ/etm
것이	것/nbn+이/jcs
아니라	아니/paa+라/ecs
보수부터	보수/ncn+부터/jxc
현실에	현실/ncn+에/jca
맞게	맞/pvg+게/ecs
줘야	주/pvg+어야/ecs
한다.	하/px+ㄴ다/ef+./sf
필자가	필자/ncn+가/jcs
기업에	기업/ncn+에/jca
몸담고	몸/ncn+담/pvg+고/ecx
있을	있/px+을/etm
때	때/ncn
업계의	업계/ncn+의/jcm
대선배가	대/xp+선배/ncn+가/jcs
해준	하/pvg+어/ecx+주/px+ㄴ/etm
이야기가	이야기/ncn+가/jcs
떠오른다.	떠오르/pvg+ㄴ다/ef+./sf
관념적이고	관념/ncn+적/xsn+이/jp+고/ecc
비현실적인	비/xp+현실/ncn+적/xsn+이/jp+ㄴ/etm
경영정책이	경영/ncn+정책/ncn+이/jcs
입사	입사/ncn
전까지	전/ncn+까지/jxc
선량하고	선량/ncps+하/xsm+고/ecc
양심적이던	양심/ncn+적/xsn+이/jp+던/etm
사원들을	사원/ncn+들/xsn+을/jco
도덕불감증	도덕/ncn+불감/ncn+증/xsn
환자로	환자/ncn+로/jca
만들고	만들/pvg+고/ecx
있다.	있/px+다/ef+./sf
그러나	그러나/maj
지난	지나/pvg+ㄴ/etm
1일	1/nno+일/nbu
당	당/ncn
지도부	지도/ncn+부/xsn
5인회의에서	5/nnc+인/nbu+회의/ncn+에서/jca
3명의	3/nnc+명/nbu+의/jcm
공동선대위원장이	공동/ncn+선대위/ncn+원장/ncn+이/jcs
이	이/nq
총재에게	총재/ncn+에게/jca
김	김/nq
대통령과의	대통령/ncn+과/jct+의/jcm
회동을	회동/ncn+을/jco
권유하는	권유/ncpa+하/xsv+는/etm
등	등/nbn
이	이/mmd
문제를	문제/ncn+를/jco
두고	두/pvg+고/ecs
당	당/ncn
내부에	내부/ncn+에/jca
양론이	양론/ncn+이/jcs
맞서고	맞서/pvg+고/ecx
있다.	있/px+다/ef+./sf
이	이/nq
총재	총재/ncn
진영의	진영/ncn+의/jcm
상당수	상당/ncn+수/ncn
인사들도	인사/ncn+들/xsn+도/jxc
청와대쪽에서	청와대/nq+쪽/nbn+에서/jca
회동을	회동/ncn+을/jco
다시	다시/mag
추진할	추진/ncpa+하/xsv+ㄹ/etm
수	수/nbn
있는	있/paa+는/etm
신호가	신호/ncn+가/jcs
오기를	오/pvg+기/etn+를/jco
기대하는	기대/ncpa+하/xsv+는/etm
분위기다.	분위기/ncn+다/ef+./sf
김	김/nq
대통령이	대통령/ncn+이/jcs
탈당	탈당/ncn
의사를	의사/ncn+를/jco
전해온다면	전하/pvg+어/ecs+오/pvg+ㄴ다/ef+면/ecs
두	두/nnc
사람이	사람/ncn+이/jcs
다시	다시/mag
만날	만나/pvg+ㄹ/etm
수	수/nbn
있는	있/paa+는/etm
계기가	계기/ncn+가/jcs
마련될	마련/ncpa+되/xsv+ㄹ/etm
수도	수/nbn+도/jxc
있다는	있/paa+다/ef+는/etm
판단이다.	판단/ncn+이/jp+다/ef+./sf
이	이/nq
총재쪽의	총재/ncn+쪽/nbn+의/jcm
이런	이런/mmd
태도	태도/ncn
변화는	변화/ncn+는/jxc
당에	당/ncn+에/jca
남아	남/pvg+아/ecx
있는	있/px+는/etm
관망파	관망/ncn+파/ncn
인사들을	인사/ncn+들/xsn+을/jco
붙잡기	붙잡/pvg+기/etn
위해서는	위하/pvg+어서/ecs+는/jxc
어떤	어떤/mmd
식으로든	식/nbn+으로/jca+든/jxc
김	김/nq
대통령과의	대통령/ncn+과/jct+의/jcm
관계를	관계/ncn+를/jco
매끄럽게	매끄럽/paa+게/ecs
`정리'하는	`/sl+정리/ncn+'/sr+하/pvg+는/etm
게	거/nbn+이/jcs
필요하다는	필요/ncps+하/xsm+다/ef+는/etm
판단에	판단/ncn+에/jca
따른	따르/pvg+ㄴ/etm
것으로	것/nbn+으로/jca
보인다.	보이/pvg+ㄴ다/ef+./sf
최근의	최근/ncn+의/jcm
각종	각종/ncn
여론조사에서도	여론/ncn+조사/ncn+에서/jca+도/jxc
이	이/nq
총재의	총재/ncn+의/jcm
김	김/nq
대통령	대통령/ncn
탈당	탈당/ncn
요구에	요구/ncn+에/jca
대해	대하/pvg+어/ecs
부정적인	부정/ncn+적/xsn+이/jp+ㄴ/etm
반응이	반응/ncn+이/jcs
더	더/mag
많은	많/paa+은/etm
것으로	것/nbn+으로/jca
나타나	나타나/pvg+아/ecs
이	이/nq
총재가	총재/ncn+가/jcs
또하나의	또/mag+하나/ncn+의/jcm
`자충수'를	`/sl+자충수/ncn+'/sr+를/jco
두었다는	두/pvg+었/ep+다/ef+는/etm
비판도	비판/ncn+도/jxc
나오고	나오/pvg+고/ecx
있다.	있/px+다/ef+./sf
그러나	그러나/maj
청와대	청와대/nq
회동에	회동/ncn+에/jca
반대하는	반대/ncpa+하/xsv+는/etm
쪽도	쪽/nbn+도/jxc
쉽게	쉽/paa+게/ecs
뜻을	뜻/ncn+을/jco
굽히지	굽히/pvg+지/ecx
않을	않/px+을/etm
태세다.	태세/ncn+다/ef+./sf
이	이/nq
총재	총재/ncn
본인이	본인/ncn+이/jcs
검찰의	검찰/ncn+의/jcm
수사	수사/ncn
착수	착수/ncn
지시를	지시/ncn+를/jco
회동의	회동/ncn+의/jcm
전제조건으로	전제/ncn+조건/ncn+으로/jca
내세웠는데	내/pvg+어/ecs+세우/pvg+었/ep+는데/ecs
상황이	상황/ncn+이/jcs
그	그/mmd
때와	때/ncn+와/jct
전혀	전혀/mag
달라지지	다르/pvg+아/ecx+지/px+지/ecx
않았다는	않/px+았/ep+다/ef+는/etm
것이다.	것/nbn+이/jp+다/ef+./sf
이	이/nq
총재	총재/ncn
진영의	진영/ncn+의/jcm
강경파는	강경/ncn+파/ncn+는/jxc
또	또/maj
김영삼	김영삼/nq
총재	총재/ncn
시절	시절/ncn
비서실장이던	비서/ncn+실장/ncn+이/jp+던/etm
박범진	박범진/nq
의원이	의원/ncn+이/jcs
탈당해	탈당/ncpa+하/xsv+어/ecs
국민신당에	국민신당/nq+에/jca
합류하기로	합류/ncpa+하/xsv+기/etn+로/jca
함에	하/pvg+ㅁ/etn+에/jca
따라	따르/pvg+아/ecs
이	이/nq
총재쪽은	총재/ncn+쪽/nbn+은/jxc
김	김/nq
대통령의	대통령/ncn+의/jcm
의중이	의중/ncn+이/jcs
이인제	이인제/nq
전	전/mma
경기지사에게	경기/nq+지사/ncn+에게/jca
기울어	기울/pvg+어/ecx
있다고	있/px+다고/ecs
더욱	더욱/mag
확신하는	확신/ncpa+하/xsv+는/etm
모습이다.	모습/ncn+이/jp+다/ef+./sf
이	이/nq
총재가	총재/ncn+가/jcs
애초	애초/mag
요구한	요구/ncpa+하/xsv+ㄴ/etm
전제조건이	전제/ncn+조건/ncn+이/jcs
충족되지	충족/ncpa+되/xsv+지/ecx
않은	않/px+은/etm
상황에서	상황/ncn+에서/jca
청와대	청와대/nq
회동을	회동/ncn+을/jco
다시	다시/mag
추진하는	추진/ncpa+하/xsv+는/etm
것은	것/nbn+은/jxc
오락가락하는	오락가락/mag+하/xsv+는/etm
모습으로	모습/ncn+으로/jca
비쳐지는	비치/pvg+어/ecx+지/px+는/etm
역효과만	역/xp+효과/ncn+만/jxc
있다는	있/paa+다/ef+는/etm
판단인	판단/ncn+이/jp+ㄴ/etm
셈이다.	셈/nbn+이/jp+다/ef+./sf
민주당이	민주당/nq+이/jcs
조순	조순/nq
총재의	총재/ncn+의/jcm
진로문제로	진로/ncn+문제/ncn+로/jca
뒤숭숭하다.	뒤숭숭/mag+하/xsm+다/ef+./sf
물론	물론/mag
그는	그/npp+는/jxc
이	이/mmd
선택이	선택/ncn+이/jcs
중도하차를	중도/ncn+하차/ncn+를/jco
의미하는	의미/ncpa+하/xsv+는/etm
것으로	것/nbn+으로/jca
해석하지	해석/ncpa+하/xsv+지/ecx
말아	말/px+아/ecx
달라고	달/px+라/ef+고/jcr
주문했다.	주문/ncpa+하/xsv+었/ep+다/ef+./sf
하지만	하지만/maj
당의	당/ncn+의/jcm
분위기는	분위기/ncn+는/jxc
다르다.	다르/paa+다/ef+./sf
당	당/ncn
관계자	관계/ncn+자/xsn
상당수가	상당/ncn+수/ncn+가/jcs
이미	이미/mag
조	조/nq
총재의	총재/ncn+의/jcm
`홀로서기'보다는	`/sl+홀로서기/ncn+'/sr+보다/jca+는/jxc
누구와,	누구/npp+와/jct+,/sp
어떤	어떤/mmd
방식으로	방식/ncn+으로/jca
연합해야	연합/ncpa+하/xsv+어야/ecs
하느냐는	하/px+느냐/ef+는/etm
쪽에	쪽/nbn+에/jca
관심을	관심/ncn+을/jco
더	더/mag
쏟고	쏟/pvg+고/ecx
있다.	있/px+다/ef+./sf
대선을	대선/ncn+을/jco
불과	불과/mag
40여일	40/nnc+여/xsn+일/nbu
앞둔	앞/ncn+두/pvg+ㄴ/etm
시점에서	시점/ncn+에서/jca
대선기획단장이	대선/ncn+기획/ncn+단장/ncn+이/jcs
`차선책'을	`/sl+차선/ncn+책/xsn+'/sr+을/jco
언급하며	언급/ncpa+하/xsv+며/ecs
지구당위원장들을	지구/ncn+당/ncn+위원/ncn+장/xsn+들/xsn+을/jco
달랜다는	달래/pvg+ㄴ다/ef+는/etm
것은	것/nbn+은/jxc
정상적인	정상/ncn+적/xsn+이/jp+ㄴ/etm
상황은	상황/ncn+은/jxc
아닌	아니/paa+ㄴ/etm
것이다.	것/nbn+이/jp+다/ef+./sf
조	조/nq
총재	총재/ncn
본인은	본인/ncn+은/jxc
이회창	이회창/nq
총재와의	총재/ncn+와/jct+의/jcm
연대에	연대/ncn+에/jca
더	더/mag
관심을	관심/ncn+을/jco
두고	두/pvg+고/ecx
있는	있/px+는/etm
것으로	것/nbn+으로/jca
알려졌다.	알리/pvg+어/ecx+지/px+었/ep+다/ef+./sf
이인제	이인제/nq
전	전/mma
지사쪽이	지사/ncn+쪽/nbn+이/jcs
민주당에	민주당/nq+에/jca
대해	대하/pvg+어/ecs
세몰이를	세몰이/ncn+를/jco
통한	통하/pvg+ㄴ/etm
`흡수단일화'	`/sl+흡수/ncn+단일/ncn+화/xsn+'/sr
전략을	전략/ncn+을/jco
구사하는	구사/ncpa+하/xsv+는/etm
데	데/nbn
대해	대하/pvg+어/ecs
상당한	상당/ncps+하/xsm+ㄴ/etm
불만을	불만/ncn+을/jco
갖고	갖/pvg+고/ecx
있는	있/px+는/etm
것이다.	것/nbn+이/jp+다/ef+./sf
이에	이/npd+에/jca
따라	따르/pvg+아/ecs
당이	당/ncn+이/jcs
자칫	자칫/mag
`사분오열'될	`/sl+사분오열/ncn+'/sr+되/pvg+ㄹ/etm
수	수/nbn
있다는	있/paa+다/ef+는/etm
우려가	우려/ncn+가/jcs
일부에서	일부/ncn+에서/jca
나오고	나오/pvg+고/ecx
있다.	있/px+다/ef+./sf
당을	당/ncn+을/jco
어떻게든	어떻/pad+게/ecs+든/jxc
온전히	온전/ncn+히/xsa
유지해	유지/ncpa+하/xsv+어/ecs
대선	대선/ncn
정국에서	정국/ncn+에서/jca
`캐스팅	`/sl+캐스팅/ncn
보트'	보트/ncn+'/sr
역할을	역할/ncn+을/jco
해보자는	하/pvg+어/ecx+보/px+자/ef+는/etm
포석인	포석/ncn+이/jp+ㄴ/etm
셈이다.	셈/nbn+이/jp+다/ef+./sf
김영삼	김영삼/nq
대통령이	대통령/ncn+이/jcs
과연	과연/mag
신한국당을	신한국당/nq+을/jco
탈당할까.	탈당/ncpa+하/xsv+ㄹ까/ef+./sf
한다면	하/pvg+ㄴ다/ef+면/ecs
그	그/mmd
시기는	시기/ncn+는/jxc
언제쯤이	언제/npd+쯤/xsn+이/jcs
될까.	되/pvg+ㄹ까/ef+./sf
사실	사실/mag
김	김/nq
대통령의	대통령/ncn+의/jcm
탈당	탈당/ncn
문제는	문제/ncn+는/jxc
정치적	정치/ncn+적/xsn
계산이	계산/ncn+이/jcs
매우	매우/mag
복잡한	복잡/ncps+하/xsm+ㄴ/etm
고차방정식이다.	고차/ncn+방정/ncn+식/ncn+이/jp+다/ef+./sf
신한국당	신한국당/nq
내분	내분/ncn
사태의	사태/ncn+의/jcm
흐름에	흐름/ncn+에/jca
결정적	결정/ncn+적/xsn
영향을	영향/ncn+을/jco
주면서	주/pvg+면서/ecs
`디제이피	`/sl+디제이피/nq
연합'에	연합/ncn+'/sr+에/jca
대응하는	대응/ncpa+하/xsv+는/etm
여권의	여권/ncn+의/jcm
새로운	새롭/paa+ㄴ/etm
판짜기	판짜기/ncn
방향을	방향/ncn+을/jco
결정짓는	결정/ncn+짓/pvg+는/etm
고도의	고도/ncn+의/jcm
정치적	정치/ncn+적/xsn
포석이기	포석/ncn+이/jp+기/etn
때문이다.	때문/nbn+이/jp+다/ef+./sf
최근	최근/ncn
청와대의	청와대/nq+의/jcm
전반적	전반/ncn+적/xsn
기류를	기류/ncn+를/jco
볼	보/pvg+ㄹ/etm
때	때/ncn
김	김/nq
대통령의	대통령/ncn+의/jcm
마음이	마음/ncn+이/jcs
이회창	이회창/nq
총재로부터	총재/ncn+로/jca+부터/jxc
완전히	완전/ncn+히/xsa
떠나	떠나/pvg+아/ecs
이인제	이인제/nq
전	전/mma
경기지사쪽으로	경기/ncn+지사/ncn+쪽/nbn+으로/jca
기울었다는	기울/pvg+었/ep+다/ef+는/etm
점은	점/ncn+은/jxc
여러모로	여러모로/mag
감지된다.	감지/ncpa+되/xsv+ㄴ다/ef+./sf
따라서	따라서/maj
김	김/nq
대통령의	대통령/ncn+의/jcm
탈당	탈당/ncn
문제는	문제/ncn+는/jxc
단적으로	단적/ncn+으로/jca
말하면	말/ncpa+하/xsv+면/ecs
대선공정관리라는	대선/ncn+공정/ncn+관리/ncn+라/ef+는/etm
`대의명분'과,	`/sl+대의/ncn+명분/ncn+'/sr+과/jcj+,/sp
이	이/nq
총재의	총재/ncn+의/jcm
고사작전	고사/ncn+작전/ncn
및	및/maj
이	이/nq
전	전/mma
지사의	지사/ncn+의/jcm
효율적	효율/ncn+적/xsn
측면지원이라는	측면/ncn+지원/ncn+이/jp+라/ef+는/etm
`정치적	`/sl+정치/ncn+적/xsn
실리'를	실리/ncn+'/sr+를/jco
어떻게	어떻/pad+게/ecs
조화할	조화/ncpa+하/xsv+ㄹ/etm
것인가라는	것/nbn+이/jp+ㄴ가/ef+라/ef+는/etm
측면에서	측면/ncn+에서/jca
결정될	결정/ncpa+되/xsv+ㄹ/etm
듯하다.	듯하/px+다/ef+./sf
이런	이런/mmd
맥락에서	맥락/ncn+에서/jca
청와대쪽은	청와대/nq+쪽/nbn+은/jxc
아직은	아직/mag+은/jxc
김	김/nq
대통령의	대통령/ncn+의/jcm
탈당이	탈당/ncn+이/jcs
시기상조라고	시기/ncn+상조/ncn+라/ef+고/jcr
여기는	여기/pvg+는/etm
듯하다.	듯하/px+다/ef+./sf
신한국당의	신한국당/nq+의/jcm
내분	내분/ncn
사태를	사태/ncn+를/jco
비롯한	비롯/ncpa+하/xsv+ㄴ/etm
정국구도가	정국/ncn+구도/ncn+가/jcs
매우	매우/mag
유동적이며	유동/ncn+적/xsn+이/jp+며/ecc
김	김/nq
대통령의	대통령/ncn+의/jcm
탈당은	탈당/ncn+은/jxc
곧바로	곧바로/mag
신한국당내	신한국당/ncn+내/nbn
`반이회창파'에	`/sl+반/xp+이회창/nq+파/ncn+'/sr+에/jca
대한	대하/pvg+ㄴ/etm
`탈당	`/sl+탈당/ncn
지시'로	지시/ncn+'/sr+로/jca
해석될	해석/ncpa+되/xsv+ㄹ/etm
수밖에	수/nbn+밖에/jxc
없는	없/paa+는/etm
상황이다.	상황/ncn+이/jp+다/ef+./sf
가뜩이나	가뜩/mag+이나/jxc
김	김/nq
대통령의	대통령/ncn+의/jcm
`이중플레이'가	`/sl+이중/ncn+플레이/ncn+'/sr+가/jcs
의심받고	의심/ncn+받/pvg+고/ecx
있는	있/px+는/etm
상황에서	상황/ncn+에서/jca
탈당을	탈당/ncn+을/jco
결행할	결행/ncpa+하/xsv+ㄹ/etm
경우	경우/ncn
대선공정관리의	대선/ncn+공정/ncn+관리/ncn+의/jcm
의지가	의지/ncn+가/jcs
부각되기보다는	부각/ncpa+되/xsv+기/etn+보다/jca+는/jxc
오히려	오히려/mag
정치적	정치/ncn+적/xsn
노림수가	노림수/ncn+가/jcs
비판의	비판/ncn+의/jcm
도마	도마/ncn
위에	위/ncn+에/jca
오를	오르/pvg+ㄹ/etm
가능성이	가능/ncn+성/xsn+이/jcs
크다.	크/paa+다/ef+./sf
이	이/nq
전	전/mma
지사의	지사/ncn+의/jcm
득표전략상으로도	득표/ncn+전략/ncn+상/xsn+으로/jca+도/jxc
`국민신당	`/sl+국민신당/nq
=김영삼당'이라는	=/sy+김영삼/nq+당/ncn+'/sr+이/jp+라/ef+는/etm
이미지	이미지/ncn
고착이	고착/ncn+이/jcs
결코	결코/mag
도움이	도움/ncn+이/jcs
못된다는	못/mag+되/pvg+ㄴ다/ef+는/etm
것을	것/nbn+을/jco
청와대도	청와대/nq+도/jxc
충분히	충분/ncn+히/xsa
인식하고	인식/ncpa+하/xsv+고/ecx
있다.	있/px+다/ef+./sf
하지만	하지만/maj
김	김/nq
대통령이	대통령/ncn+이/jcs
끝까지	끝/ncn+까지/jxc
신한국당을	신한국당/nq+을/jco
탈당하지	탈당/ncpa+하/xsv+지/ecx
않고	않/px+고/ecs
대선을	대선/ncn+을/jco
치를	치르/pvg+ㄹ/etm
것으로	것/nbn+으로/jca
단정하기란	단정/ncpa+하/xsv+기/etn+란/jxc
힘들다.	힘/ncn+들/pvg+다/ef+./sf
청와대	청와대/nq
안에서도	안/ncn+에서/jca+도/jxc
적절한	적절/ncps+하/xsm+ㄴ/etm
시점을	시점/ncn+을/jco
계기로	계기/ncn+로/jca
기존의	기존/ncn+의/jcm
입장을	입장/ncn+을/jco
수정할	수정/ncpa+하/xsv+ㄹ/etm
필요가	필요/ncn+가/jcs
있다는	있/paa+다/ef+는/etm
지적이	지적/ncn+이/jcs
제기되고	제기/ncpa+되/xsv+고/ecx
있다.	있/px+다/ef+./sf
최근	최근/ncn
김	김/nq
대통령이	대통령/ncn+이/jcs
종교계를	종교/ncn+계/xsn+를/jco
비롯한	비롯/ncpa+하/xsv+ㄴ/etm
각계	각계/ncn
원로급	원로/ncn+급/ncn
지도자들과	지도/ncn+자/xsn+들/xsn+과/jct
잇따라	잇따르/pvg+아/ecs
만나고	만나/pvg+고/ecx
있는	있/px+는/etm
것도	것/nbn+도/jxc
정국현안에	정국/ncn+현안/ncn+에/jca
대한	대하/pvg+ㄴ/etm
여론청취	여론/ncn+청취/ncn
목적뿐	목적/ncn+뿐/nbn
아니라	아니/paa+라/ecs
탈당의	탈당/ncn+의/jcm
명분축적	명분/ncn+축적/ncn
성격도	성격/ncn+도/jxc
있는	있/paa+는/etm
것으로	것/nbn+으로/jca
보인다.	보이/pvg+ㄴ다/ef+./sf
다만	다만/mag
탈당을	탈당/ncn+을/jco
하더라도	하/pvg+더라도/ecs
그	그/mmd
시기는	시기/ncn+는/jxc
신한국당의	신한국당/nq+의/jcm
내분	내분/ncn
사태나	사태/ncn+나/jcj
국민신당의	국민신당/nq+의/jcm
창당작업	창당/ncn+작업/ncn
등	등/nbn
여권의	여권/ncn+의/jcm
세력재편	세력/ncn+재편/ncn
작업이	작업/ncn+이/jcs
어느	어느/mmd
정도	정도/ncn
가닥을	가닥/ncn+을/jco
잡은	잡/pvg+은/etm
이후가	이후/ncn+가/jcs
될	되/pvg+ㄹ/etm
듯하다.	듯하/px+다/ef+./sf
여권	여권/ncn
일각에서는	일각/ncn+에서/jca+는/jxc
국회회기가	국회/ncn+회기/ncn+가/jcs
끝나는	끝/ncn+나/pvg+는/etm
오는	오/pvg+는/etm
18일	18/nno+일/nbu
전후를	전후/ncn+를/jco
점치는	점/ncn+치/pvg+는/etm
사람도	사람/ncn+도/jxc
있다.	있/paa+다/ef+./sf
이회창	이회창/nq
신한국당	신한국당/nq
총재가	총재/ncn+가/jcs
이인제	이인제/nq
전	전/mma
경기지사와는	경기/nq+지사/ncn+와/jct+는/jxc
연대할	연대/ncpa+하/xsv+ㄹ/etm
뜻이	뜻/ncn+이/jcs
없음을	없/paa+음/etn+을/jco
밝히자	밝히/pvg+자/ecs
`정권창출을	`/sl+정권/ncn+창출/ncn+을/jco
위한	위하/pvg+ㄴ/etm
국민연대'를	국민/ncn+연대/ncn+'/sr+를/jco
추진해온	추진/ncpa+하/xsv+어/ecx+오/px+ㄴ/etm
비주류	비/xp+주류/ncn
진영	진영/ncn
안에서	안/ncn+에서/jca
탈당	탈당/ncn
기운이	기운/ncn+이/jcs
확산되고	확산/ncpa+되/xsv+고/ecx
있다.	있/px+다/ef+./sf
그러나	그러나/maj
이	이/nq
총재는	총재/ncn+는/jxc
지난	지나/pvg+ㄴ/etm
1일	1/nno+일/nbu
이한동	이한동/nq
대표와	대표/ncn+와/jcj
3인	3/nnc+인/nbu
공동선대위원장이	공동/ncn+선대위/ncn+원장/ncn+이/jcs
모인	모이/pvg+ㄴ/etm
당	당/ncn
지도부	지도/ncn+부/xsn
5인회의에서	5/nnc+인/nbu+회의/ncn+에서/jca
이	이/nq
전	전/mma
지사와는	지사/ncn+와/jct+는/jxc
후보단일화를	후보/ncn+단일/ncn+화/xsn+를/jco
추진할	추진/ncpa+하/xsv+ㄹ/etm
용의가	용의/ncn+가/jcs
없음을	없/paa+음/etn+을/jco
밝혔으며,	밝히/pvg+었/ep+으며/ecc+,/sp
3일	3/nno+일/nbu
기자회견에서도	기자/ncn+회견/ncn+에서/jca+도/jxc
이를	이/npd+를/jco
다시한번	다시/mag+한/nnc+번/nbu
밝힐	밝히/pvg+ㄹ/etm
것으로	것/nbn+으로/jca
알려졌다.	알리/pvg+어/ecx+지/px+었/ep+다/ef+./sf
또	또/maj
이한동	이한동/nq
대표와	대표/ncn+와/jcj
김윤환	김윤환/nq
선대위원장	선대위/ncn+원장/ncn
진영	진영/ncn
등	등/nbn
민정계쪽의	민정/ncn+계/xsn+쪽/nbn+의/jcm
국민연대	국민/ncn+연대/ncn
동참	동참/ncn
여부	여부/ncn
역시	역시/mag
여전히	여전/ncn+히/xsa
불투명한	불/xp+투명/ncps+하/xsm+ㄴ/etm
상태다.	상태/ncn+다/ef+./sf
국민신당(가칭)이	국민신당/nq+(/sl+가칭/ncn+)/sr+이/jcs
조만간	조만간/mag
입당하거나	입당/ncpa+하/xsv+거나/ecc
이미	이미/mag
입당한	입당/ncpa+하/xsv+ㄴ/etm
현역	현역/ncn
의원들을	의원/ncn+들/xsn+을/jco
중심으로	중심/ncn+으로/jca
당직	당직/ncn
인선	인선/ncn
구상을	구상/ncn+을/jco
가다듬고	가다듬/pvg+고/ecx
있다.	있/px+다/ef+./sf
국민신당은	국민신당/nq+은/jxc
우선	우선/mag
당	당/ncn
총재로	총재/ncn+로/jca
이만섭	이만섭/nq
전	전/mma
국회의장을	국회/ncn+의장/ncn+을/jco
사실상	사실/ncn+상/xsn
확정한	확정/ncpa+하/xsv+ㄴ/etm
것으로	것/nbn+으로/jca
알려졌다.	알리/pvg+어/ecx+지/px+었/ep+다/ef+./sf
대표최고위원제로	대표/ncn+최고/ncn+위원/ncn+제/xsn+로/jca
되어	되/pvg+어/ecx
있는	있/px+는/etm
당헌은	당헌/ncn+은/jxc
총재로	총재/ncn+로/jca
바꾸기로	바꾸/pvg+기/etn+로/jca
했으며,	하/px+었/ep+으며/ecc+,/sp
이수성	이수성/nq
신한국당	신한국당/nq
고문은	고문/ncn+은/jxc
입당	입당/ncn
자체가	자체/ncn+가/jcs
불투명해짐에	불/xp+투명/ncps+하/xsm+어/ecx+지/px+ㅁ/etn+에/jca
따라	따르/pvg+아/ecs
거리가	거리/ncn+가/jcs
멀어졌다.	멀/paa+어/ecx+지/px+었/ep+다/ef+./sf
5~7명	5/nnc+~/sd+7/nnc+명/nbu
둘	두/pvg+ㄹ/etm
예정인	예정/ncn+이/jp+ㄴ/etm
최고위원은	최고/ncn+위원/ncn+은/jxc
장을병	장을병/nq
창당준비위원장만을	창당/ncn+준비/ncn+위원/ncn+장/xsn+만/jxc+을/jco
우선	우선/mag
선출하고,	선출/ncpa+하/xsv+고/ecc+,/sp
나머지는	나머지/ncn+는/jxc
영입이	영입/ncn+이/jcs
성사되는	성사/ncpa+되/xsv+는/etm
대로	대로/nbn
채워갈	채우/pvg+어/ecx+가/px+ㄹ/etm
방침이다.	방침/ncn+이/jp+다/ef+./sf
사무총장에는	사무/ncn+총장/ncn+에/jca+는/jxc
김운환	김운환/nq
의원,	의원/ncn+,/sp
정책위의장	정책위/ncn+의장/ncn
한이헌	한이헌/nq
의원,	의원/ncn+,/sp
후보비서실장	후보/ncn+비서/ncn+실장/ncn
김학원	김학원/nq
의원	의원/ncn
등이	등/nbn+이/jcs
거론되고	거론/ncpa+되/xsv+고/ecx
있다.	있/px+다/ef+./sf
그러나	그러나/maj
당직	당직/ncn
인선에는	인선/ncn+에/jca+는/jxc
가변성도	가변/ncn+성/xsn+도/jxc
있다.	있/paa+다/ef+./sf
민주계인	민주/ncn+계/xsn+이/jp+ㄴ/etm
자신이	자신/ncn+이/jcs
핵심당직인	핵심/ncn+당직/ncn+이/jp+ㄴ/etm
사무총장을	사무/ncn+총장/ncn+을/jco
맡을	맡/pvg+을/etm
경우	경우/ncn
`김영삼	`/sl+김영삼/nq
신당'	신당/ncn+'/sr
이미지가	이미지/ncn+가/jcs
굳어질	굳/paa+어/ecx+지/px+ㄹ/etm
가능성을	가능/ncn+성/xsn+을/jco
우려한다는	우려/ncpa+하/xsv+ㄴ다/ef+는/etm
것이다.	것/nbn+이/jp+다/ef+./sf
대안으로는	대안/ncn+으로/jca+는/jxc
제정구	제정구/nq
의원(민주당)이나	의원/ncn+(/sl+민주당/nq+)/sr+이나/jcj
이철	이철/nq
전	전/mma
의원의	의원/ncn+의/jcm
입당	입당/ncn
뒤	뒤/ncn
기용	기용/ncn
가능성이	가능/ncn+성/xsn+이/jcs
점쳐지고	점/ncn+치/pvg+어/ecx+지/px+고/ecx
있다.	있/px+다/ef+./sf
현역	현역/ncn
의원	의원/ncn
입당과	입당/ncn+과/jct
함께	함께/mag
무게중심이	무게/ncn+중심/ncn+이/jcs
`원내파'쪽으로	`/sl+원내/ncn+파/ncn+'/sr+쪽/nbn+으로/jca
옮아가는	옮/pvg+아/ecs+가/pvg+는/etm
듯한	듯하/px+다/ef+./sf
기류도	기류/ncn+도/jxc
흥미롭다.	흥미/ncps+롭/xsm+다/ef+./sf
지난	지나/pvg+ㄴ/etm
1일에는	1/nno+일/nbu+에/jca+는/jxc
이인제	이인제/nq
전	전/mma
경기지사와	경기/nq+지사/ncn+와/jcj
이만섭	이만섭/nq
전	전/mma
국회의장,	국회/ncn+의장/ncn+,/sp
김운환	김운화/nq
박범진	박범진/nq
이용삼	이용삼/nq
한이헌	한이헌/nq
김학원	김학원/nq
원유철	원유철/nq
의원	의원/ncn
등	등/nbn
8인이	8/nnc+인/nbu+이/jcs
모여	모이/pvg+어/ecs
대표최고위원	대표/ncn+최고/ncn+위원/ncn
중심으로	중심/ncn+으로/jca
결정된	결정/ncpa+되/xsv+ㄴ/etm
당헌을	당헌/ncn+을/jco
총재	총재/ncn
중심으로	중심/ncn+으로/jca
바꾸기로	바꾸/pvg+기/etn+로/jca
했다.	하/px+었/ep+다/ef+./sf
이	이/nq
전	전/mma
지사와	지사/ncn+와/jct
동반	동반/ncn
탈당했던	탈당/ncpa+하/xsv+었/ep+던/etm
원외	원외/ncn
지구당위원장	지구/ncn+당/ncn+위원/ncn+장/xsn
13명	13/nnc+명/nbu
중심의	중심/ncn+의/jcm
창당준비위원회	창당/ncn+준비/ncn+위원/ncn+회/xsn
결정사항이	결정/ncn+사항/ncn+이/jcs
간단히	간단/ncn+히/xsa
뒤집힌	뒤집히/pvg+ㄴ/etm
것이다.	것/nbn+이/jp+다/ef+./sf
이	이/mmd
자리에선	자리/ncn+에서/jca+ㄴ/jxc
이	이/nq
전	전/mma
의장이	의장/ncn+이/jcs
우회적으로	우회/ncn+적/xsn+으로/jca
`총재직'에	`/sl+총재/ncn+직/xsn+'/sr+에/jca
대한	대하/pvg+ㄴ/etm
희망을	희망/ncn+을/jco
비친	비치/pvg+ㄴ/etm
것으로	것/nbn+으로/jca
알려졌다.	알리/pvg+어/ecx+지/px+었/ep+다/ef+./sf
80년	80/nno+년/nbu
신군부의	신/xp+군부/ncn+의/jcm
군사쿠데타로	군사/ncn+쿠데타/ncn+로/jca
5공정권이	5/nno+공/ncn+정권/ncn+이/jcs
들어선	들/pvg+어/ecs+서/pvg+ㄴ/etm
이후	이후/ncn
`국민대화합'을	`/sl+국민/ncn+대/xp+화합/ncn+'/sr+을/jco
명분으로	명분/ncn+으로/jca
한	하/pvg+ㄴ/etm
대대적인	대대적/ncn+이/jp+ㄴ/etm
사면조처는	사면/ncn+조처/ncn+는/jxc
수차례	수차례/ncn
이뤄져왔다.	이루/pvg+어/ecx+지/px+어/ecx+오/px+았/ep+다/ef+./sf
대상자	대상/ncn+자/xsn
가운데는	가운데/ncn+는/jxc
이른바	이른바/maj
국가보안법	국가/ncn+보안/ncn+법/ncn
위반사범도	위반/ncn+사범/ncn+도/jxc
대거	대거/mag
포함했다.	포함/ncpa+하/xsv+었/ep+다/ef+./sf
최근	최근/ncn
일고	일/pvg+고/ecx
있는	있/px+는/etm
양심수	양심/ncn+수/xsn
논란과	논란/ncn+과/jct
관련해	관련/ncpa+하/xsv+어/ecs
신한국당과	신한국당/nq+과/jcj
법무부의	법무부/nq+의/jcm
시각으로	시각/ncn+으로/jca
본다면	보/pvg+ㄴ다/ef+면/ecs
결코	결코/mag
양심수가	양심/ncn+수/xsn+가/jcs
될	되/pvg+ㄹ/etm
수	수/nbn
없으며	없/paa+으며/ecs
사면받을	사면/ncn+받/xsv+을/etm
수	수/nbn
없었던	없/paa+었/ep+던/etm
사람들이다.	사람/ncn+들/xsn+이/jp+다/ef+./sf
물론	물론/mag
이들	이/npp+들/xsn
가운데	가운데/ncn
상당수는	상당/ncn+수/ncn+는/jxc
현재	현재/ncn
야당뿐만	야당/ncn+뿐/jxc+만/jxc
아니라	아니/paa+라/ecs
신한국당에서	신한국당/nq+에서/jca
활동하고	활동/ncpa+하/xsv+고/ecx
있다.	있/px+다/ef+./sf
김영삼	김영삼/nq
대통령은	대통령/ncn+은/jxc
93년	93/nno+년/nbu
3월6일	3/nno+월/nbu+6/nno+일/nbu
대통령에	대통령/ncn+에/jca
취임한	취임/ncpa+하/xsv+ㄴ/etm
직후	직후/ncn
대사면을	대/xp+사면/ncn+을/jco
단행했다.	단행/ncpa+하/xsv+었/ep+다/ef+./sf
</tdmsfile>
</tdmsfile>
